id,season,name,gp,goals,assists,points,shp,xg
8475798,20242025,Mikael Granlund,31,7,14,21,0.162791,18.6
8475798,20232024,Mikael Granlund,69,12,48,60,0.089552,15.74
8475798,20222023,Mikael Granlund,21,1,4,5,0.026316,19.2
8475798,20212022,Mikael Granlund,80,11,53,64,0.094,14.63
8475798,20202021,Mikael Granlund,51,13,14,27,0.176,11.88
8475798,20192020,Mikael Granlund,63,17,13,30,0.131,
8475798,20182019,Mikael Granlund,16,1,4,5,0.0345,
8475798,20172018,Mikael Granlund,77,21,46,67,0.1088,
8475798,20162017,Mikael Granlund,81,26,43,69,0.1469,
8475798,20152016,Mikael Granlund,82,13,31,44,0.0813,
8475798,20142015,Mikael Granlund,68,8,31,39,0.0808,
8475798,20132014,Mikael Granlund,63,8,33,41,0.0769,
8475798,20122013,Mikael Granlund,27,2,6,8,0.0556,
8478424,20242025,Jansen Harkins,62,2,4,6,0.040816,4.45
8478424,20232024,Jansen Harkins,45,0,4,4,0.0,3.05
8478424,20222023,Jansen Harkins,22,3,2,5,0.166667,2.3
8478424,20212022,Jansen Harkins,77,7,6,13,0.104,6.43
8478424,20202021,Jansen Harkins,26,1,1,2,0.063,2.08
8478424,20192020,Jansen Harkins,29,2,5,7,0.069,
8477527,20242025,Ross Johnston,43,1,3,4,0.111111,1.52
8477527,20232024,Ross Johnston,68,1,3,4,0.022727,4.83
8477527,20222023,Ross Johnston,16,0,2,2,0.0,0.34
8477527,20212022,Ross Johnston,32,2,5,7,0.222,1.38
8477527,20202021,Ross Johnston,12,0,1,1,0.0,0.37
8477527,20192020,Ross Johnston,32,3,1,4,0.188,
8477527,20182019,Ross Johnston,17,1,3,4,0.0833,
8477527,20172018,Ross Johnston,24,3,3,6,0.1579,
8473986,20242025,Alex Killorn,82,19,18,37,0.141791,15.81
8473986,20232024,Alex Killorn,63,18,18,36,0.124138,20.2
8473986,20222023,Alex Killorn,82,27,37,64,0.188811,20.81
8473986,20212022,Alex Killorn,82,25,34,59,0.152,23.13
8473986,20202021,Alex Killorn,56,15,18,33,0.124,14.14
8473986,20192020,Alex Killorn,68,26,23,49,0.2,
8473986,20182019,Alex Killorn,82,18,22,40,0.1176,
8473986,20172018,Alex Killorn,82,15,32,47,0.0962,
8473986,20162017,Alex Killorn,81,19,17,36,0.108,
8473986,20152016,Alex Killorn,81,14,26,40,0.0909,
8473986,20142015,Alex Killorn,71,15,23,38,0.1154,
8473986,20132014,Alex Killorn,82,17,24,41,0.0983,
8473986,20122013,Alex Killorn,38,7,12,19,0.0854,
8475184,20242025,Chris Kreider,68,22,8,30,0.144737,24.52
8475184,20232024,Chris Kreider,82,39,36,75,0.158537,38.8
8475184,20222023,Chris Kreider,79,36,18,54,0.157205,36.79
8475184,20212022,Chris Kreider,81,52,25,77,0.202,38.9
8475184,20202021,Chris Kreider,50,20,10,30,0.196,17.43
8475184,20192020,Chris Kreider,63,24,21,45,0.154,
8475184,20182019,Chris Kreider,79,28,24,52,0.1393,
8475184,20172018,Chris Kreider,58,16,21,37,0.1168,
8475184,20162017,Chris Kreider,75,28,25,53,0.1505,
8475184,20152016,Chris Kreider,79,21,22,43,0.1329,
8475184,20142015,Chris Kreider,80,21,25,46,0.1167,
8475184,20132014,Chris Kreider,66,17,20,37,0.125,
8475184,20122013,Chris Kreider,23,2,1,3,0.1053,
8480068,20242025,Ryan Poehling,68,12,19,31,0.169014,9.86
8480068,20232024,Ryan Poehling,77,11,17,28,0.099099,11.91
8480068,20222023,Ryan Poehling,53,7,7,14,0.109375,8.46
8480068,20212022,Ryan Poehling,57,9,8,17,0.099,9.95
8476458,20242025,Ryan Strome,82,10,31,41,0.072993,19.16
8476458,20232024,Ryan Strome,79,11,30,41,0.083969,12.98
8476458,20222023,Ryan Strome,82,15,26,41,0.115385,13.28
8476458,20212022,Ryan Strome,74,21,33,54,0.13,17.26
8476458,20202021,Ryan Strome,56,14,35,49,0.109,13.34
8476458,20192020,Ryan Strome,70,18,41,59,0.117,
8476458,20182019,Ryan Strome,63,18,15,33,0.225,
8476458,20172018,Ryan Strome,82,13,21,34,0.0884,
8476458,20162017,Ryan Strome,69,13,17,30,0.114,
8476458,20152016,Ryan Strome,71,8,20,28,0.0606,
8476458,20142015,Ryan Strome,81,17,33,50,0.095,
8476458,20132014,Ryan Strome,37,7,11,18,0.0787,
8478873,20242025,Troy Terry,77,21,34,55,0.111702,24.45
8478873,20232024,Troy Terry,76,20,34,54,0.116279,18.27
8478873,20222023,Troy Terry,70,23,38,61,0.12234,25.34
8478873,20212022,Troy Terry,75,37,30,67,0.193,24.77
8478873,20202021,Troy Terry,48,7,13,20,0.101,6.78
8478873,20192020,Troy Terry,47,4,11,15,0.055,
8478873,20182019,Troy Terry,32,4,9,13,0.16,
8478873,20172018,Troy Terry,2,0,0,0,0.0,
8478366,20242025,Frank Vatrano,81,21,24,45,0.089744,28.9
8478366,20232024,Frank Vatrano,82,37,23,60,0.136029,28.86
8478366,20222023,Frank Vatrano,81,22,19,41,0.095238,19.93
8478366,20212022,Frank Vatrano,22,8,5,13,0.143,13.97
8478366,20202021,Frank Vatrano,56,18,8,26,0.114,16.13
8478366,20192020,Frank Vatrano,69,16,18,34,0.099,
8478366,20182019,Frank Vatrano,81,24,15,39,0.1154,
8478366,20172018,Frank Vatrano,16,5,3,8,0.1667,
8478366,20162017,Frank Vatrano,44,10,8,18,0.0862,
8478366,20152016,Frank Vatrano,39,8,3,11,0.0808,
8475462,20242025,Radko Gudas,81,1,15,16,0.011236,3.41
8475462,20232024,Radko Gudas,66,6,12,18,0.068182,3.08
8475462,20222023,Radko Gudas,72,2,15,17,0.018182,4.06
8475462,20212022,Radko Gudas,77,3,13,16,0.03,4.09
8475462,20202021,Radko Gudas,54,2,9,11,0.024,2.7
8475462,20192020,Radko Gudas,63,2,13,15,0.022,
8475462,20182019,Radko Gudas,77,4,16,20,0.0294,
8475462,20172018,Radko Gudas,70,2,14,16,0.0141,
8475462,20162017,Radko Gudas,67,6,17,23,0.0531,
8475462,20152016,Radko Gudas,76,5,9,14,0.0333,
8475462,20142015,Radko Gudas,31,2,3,5,0.0317,
8475462,20132014,Radko Gudas,73,3,19,22,0.0263,
8475462,20122013,Radko Gudas,22,2,3,5,0.0645,
8476885,20242025,Jacob Trouba,53,1,7,8,0.015385,3.64
8476885,20232024,Jacob Trouba,69,3,19,22,0.023256,5.69
8476885,20222023,Jacob Trouba,82,8,22,30,0.040201,8.5
8476885,20212022,Jacob Trouba,81,11,28,39,0.054,10.69
8476885,20202021,Jacob Trouba,38,2,10,12,0.029,3.09
8476885,20192020,Jacob Trouba,70,7,20,27,0.042,
8476885,20182019,Jacob Trouba,82,8,42,50,0.0494,
8476885,20172018,Jacob Trouba,55,3,21,24,0.0208,
8476885,20162017,Jacob Trouba,60,8,25,33,0.0519,
8476885,20152016,Jacob Trouba,81,6,15,21,0.0451,
8476885,20142015,Jacob Trouba,65,7,15,22,0.0526,
8476885,20132014,Jacob Trouba,65,10,19,29,0.0826,
8478042,20242025,Viktor Arvidsson,67,15,12,27,0.094937,16.18
8478042,20232024,Viktor Arvidsson,18,6,9,15,0.101695,6.22
8478042,20222023,Viktor Arvidsson,77,26,33,59,0.114035,26.18
8478042,20212022,Viktor Arvidsson,66,20,29,49,0.088,25.6
8478042,20202021,Viktor Arvidsson,50,10,15,25,0.066,13.82
8478042,20192020,Viktor Arvidsson,57,15,13,28,0.118,
8478042,20182019,Viktor Arvidsson,58,34,14,48,0.1744,
8478042,20172018,Viktor Arvidsson,78,29,32,61,0.1174,
8478042,20162017,Viktor Arvidsson,80,31,30,61,0.126,
8478042,20152016,Viktor Arvidsson,56,8,8,16,0.0576,
8478042,20142015,Viktor Arvidsson,6,0,0,0,0.0,
8477887,20242025,Patrick Brown,15,0,1,1,0.0,1.04
8477887,20232024,Patrick Brown,11,0,1,1,0.0,0.55
8477887,20222023,Patrick Brown,18,2,3,5,0.125,5.38
8477887,20212022,Patrick Brown,44,4,5,9,0.078,4.92
8477887,20202021,Patrick Brown,4,0,0,0,0.0,0.19
8477887,20192020,Patrick Brown,1,1,0,1,0.5,
8479987,20242025,Morgan Geekie,77,33,24,57,0.22,20.44
8479987,20232024,Morgan Geekie,76,17,22,39,0.130769,13.56
8479987,20222023,Morgan Geekie,69,9,19,28,0.111111,9.39
8479987,20212022,Morgan Geekie,73,7,15,22,0.072,9.72
8479987,20202021,Morgan Geekie,36,3,6,9,0.1,2.96
8479987,20192020,Morgan Geekie,2,3,1,4,0.75,
8479661,20242025,Tanner Jeannot,67,7,6,13,0.125,8.76
8479661,20232024,Tanner Jeannot,55,7,7,14,0.118644,9.11
8479661,20222023,Tanner Jeannot,20,1,3,4,0.05,14.95
8479661,20212022,Tanner Jeannot,81,24,17,41,0.194,17.98
8479661,20202021,Tanner Jeannot,15,5,2,7,0.217,2.95
8476374,20242025,Sean Kuraly,82,6,11,17,0.068182,10.28
8476374,20232024,Sean Kuraly,62,9,9,18,0.097826,8.45
8476374,20222023,Sean Kuraly,71,11,9,20,0.11,13.35
8476374,20212022,Sean Kuraly,77,14,16,30,0.116,14.2
8476374,20202021,Sean Kuraly,47,4,5,9,0.045,6.59
8476374,20192020,Sean Kuraly,69,6,17,23,0.063,
8476374,20182019,Sean Kuraly,71,8,13,21,0.0597,
8476374,20172018,Sean Kuraly,75,6,8,14,0.0448,
8476374,20162017,Sean Kuraly,8,0,1,1,0.0,
8477496,20242025,Elias Lindholm,82,17,30,47,0.111842,25.21
8477496,20232024,Elias Lindholm,26,6,6,12,0.142857,20.5
8477496,20222023,Elias Lindholm,80,22,42,64,0.11828,26.94
8477496,20212022,Elias Lindholm,82,42,40,82,0.179,27.52
8477496,20202021,Elias Lindholm,56,19,28,47,0.146,13.93
8477496,20192020,Elias Lindholm,70,29,25,54,0.172,
8477496,20182019,Elias Lindholm,81,27,51,78,0.1484,
8477496,20172018,Elias Lindholm,81,16,28,44,0.1046,
8477496,20162017,Elias Lindholm,72,11,34,45,0.0728,
8477496,20152016,Elias Lindholm,82,11,28,39,0.0625,
8477496,20142015,Elias Lindholm,81,17,22,39,0.1,
8477496,20132014,Elias Lindholm,58,9,12,21,0.1286,
8479999,20242025,Casey Mittelstadt,18,4,2,6,0.173913,14.29
8479999,20232024,Casey Mittelstadt,18,4,6,10,0.16,15.58
8479999,20222023,Casey Mittelstadt,82,15,44,59,0.111111,14.36
8479999,20212022,Casey Mittelstadt,40,6,13,19,0.076,6.96
8479999,20202021,Casey Mittelstadt,41,10,12,22,0.164,6.56
8479999,20192020,Casey Mittelstadt,31,4,5,9,0.118,
8479999,20182019,Casey Mittelstadt,77,12,13,25,0.1017,
8479999,20172018,Casey Mittelstadt,6,1,4,5,0.1111,
8477956,20242025,David Pastrnak,82,43,63,106,0.134796,30.39
8477956,20232024,David Pastrnak,82,47,63,110,0.123037,37.46
8477956,20222023,David Pastrnak,82,61,52,113,0.149877,45.36
8477956,20212022,David Pastrnak,72,40,37,77,0.128,31.08
8477956,20202021,David Pastrnak,48,20,28,48,0.114,15.14
8477956,20192020,David Pastrnak,70,48,47,95,0.172,
8477956,20182019,David Pastrnak,66,38,43,81,0.1617,
8477956,20172018,David Pastrnak,82,35,45,80,0.1423,
8477956,20162017,David Pastrnak,75,34,36,70,0.1298,
8477956,20152016,David Pastrnak,51,15,11,26,0.1389,
8477956,20142015,David Pastrnak,46,10,17,27,0.1075,
8478401,20242025,Pavel Zacha,82,14,33,47,0.106061,20.95
8478401,20232024,Pavel Zacha,78,21,38,59,0.141892,18.46
8478401,20222023,Pavel Zacha,82,21,36,57,0.160305,16.91
8478401,20212022,Pavel Zacha,70,15,21,36,0.101,18.47
8478401,20202021,Pavel Zacha,50,17,18,35,0.165,11.69
8478401,20192020,Pavel Zacha,65,8,24,32,0.082,
8478401,20182019,Pavel Zacha,61,13,12,25,0.1313,
8478401,20172018,Pavel Zacha,69,8,17,25,0.0714,
8478401,20162017,Pavel Zacha,70,8,16,24,0.0964,
8478401,20152016,Pavel Zacha,1,0,2,2,0.0,
8480035,20242025,Henri Jokiharju,18,0,4,4,0.0,1.97
8480035,20232024,Henri Jokiharju,74,3,17,20,0.035714,3.33
8480035,20222023,Henri Jokiharju,60,3,10,13,0.037975,3.08
8480035,20212022,Henri Jokiharju,60,3,16,19,0.036,3.83
8480035,20202021,Henri Jokiharju,46,3,5,8,0.06,1.74
8480035,20192020,Henri Jokiharju,69,4,11,15,0.051,
8480035,20182019,Henri Jokiharju,38,0,12,12,0.0,
8476854,20242025,Hampus Lindholm,17,3,4,7,0.085714,2.02
8476854,20232024,Hampus Lindholm,73,3,23,26,0.030303,6.1
8476854,20222023,Hampus Lindholm,80,10,43,53,0.063291,9
8476854,20212022,Hampus Lindholm,10,0,5,5,0.0,6.28
8476854,20202021,Hampus Lindholm,18,2,4,6,0.069,1.98
8476854,20192020,Hampus Lindholm,56,2,21,23,0.018,
8476854,20182019,Hampus Lindholm,76,6,22,28,0.048,
8476854,20172018,Hampus Lindholm,69,13,18,31,0.0992,
8476854,20162017,Hampus Lindholm,66,6,14,20,0.0638,
8476854,20152016,Hampus Lindholm,80,10,18,28,0.0671,
8476854,20142015,Hampus Lindholm,78,7,27,34,0.0654,
8476854,20132014,Hampus Lindholm,78,6,24,30,0.0517,
8479325,20242025,Charlie McAvoy,50,7,16,23,0.071429,5.77
8479325,20232024,Charlie McAvoy,74,12,35,47,0.090226,8.99
8479325,20222023,Charlie McAvoy,67,7,45,52,0.066667,7.05
8479325,20212022,Charlie McAvoy,78,10,46,56,0.06,8.86
8479325,20202021,Charlie McAvoy,51,5,25,30,0.054,5.05
8479325,20192020,Charlie McAvoy,67,5,27,32,0.05,
8479325,20182019,Charlie McAvoy,54,7,21,28,0.0886,
8479325,20172018,Charlie McAvoy,63,7,25,32,0.0909,
8479369,20242025,Andrew Peeke,76,1,16,17,0.0125,3.34
8479369,20232024,Andrew Peeke,15,0,2,2,0.0,1.07
8479369,20222023,Andrew Peeke,80,6,7,13,0.066667,3.34
8479369,20212022,Andrew Peeke,82,2,13,15,0.028,3.43
8479369,20202021,Andrew Peeke,11,0,3,3,0.0,0.25
8479369,20192020,Andrew Peeke,22,1,2,3,0.043,
8477507,20242025,Nikita Zadorov,81,4,18,22,0.038095,5.44
8477507,20232024,Nikita Zadorov,54,5,9,14,0.081967,3.23
8477507,20222023,Nikita Zadorov,82,14,7,21,0.107692,6.06
8477507,20212022,Nikita Zadorov,74,4,18,22,0.038,4.17
8477507,20202021,Nikita Zadorov,55,1,7,8,0.019,1.82
8477507,20192020,Nikita Zadorov,64,4,9,13,0.062,
8477507,20182019,Nikita Zadorov,70,7,7,14,0.07,
8477507,20172018,Nikita Zadorov,77,7,13,20,0.0745,
8477507,20162017,Nikita Zadorov,56,0,10,10,0.0,
8477507,20152016,Nikita Zadorov,22,0,2,2,0.0,
8477507,20142015,Nikita Zadorov,60,3,12,15,0.0577,
8477507,20132014,Nikita Zadorov,7,1,0,1,0.25,
8478413,20242025,Jordan Greenway,34,3,5,8,0.083333,5.14
8478413,20232024,Jordan Greenway,67,10,18,28,0.093458,14.21
8478413,20222023,Jordan Greenway,17,4,0,4,0.129032,12.17
8478413,20212022,Jordan Greenway,62,10,17,27,0.091,14.37
8478413,20202021,Jordan Greenway,56,6,26,32,0.075,7.51
8478413,20192020,Jordan Greenway,67,8,20,28,0.086,
8478413,20182019,Jordan Greenway,81,12,12,24,0.1101,
8478413,20172018,Jordan Greenway,6,0,1,1,0.0,
8481522,20242025,Peyton Krebs,81,10,18,28,0.125,10.46
8481522,20232024,Peyton Krebs,80,4,13,17,0.054054,7.11
8481522,20222023,Peyton Krebs,74,9,17,26,0.115385,8.51
8481522,20212022,Peyton Krebs,48,7,15,22,0.152,4.86
8481522,20202021,Peyton Krebs,4,0,1,1,0.0,0.24
8479359,20242025,Beck Malenstyn,76,4,6,10,0.059701,7.04
8479359,20232024,Beck Malenstyn,81,6,15,21,0.061224,10.99
8479359,20222023,Beck Malenstyn,9,1,1,2,0.142857,0.41
8479359,20212022,Beck Malenstyn,12,1,0,1,0.1,0.92
8480802,20242025,Ryan McLeod,79,20,33,53,0.206186,16.71
8480802,20232024,Ryan McLeod,81,12,18,30,0.113208,13.2
8480802,20222023,Ryan McLeod,57,11,12,23,0.141026,9.32
8480802,20212022,Ryan McLeod,71,9,12,21,0.11,8.39
8480802,20202021,Ryan McLeod,10,0,1,1,0.0,0.28
8480064,20242025,Josh Norris,3,1,1,2,0.5,13.33
8480064,20232024,Josh Norris,50,16,14,30,0.13913,12.94
8480064,20222023,Josh Norris,8,2,1,3,0.133333,2.66
8480064,20212022,Josh Norris,66,35,20,55,0.203,26.17
8480064,20202021,Josh Norris,56,17,18,35,0.177,12.48
8480064,20192020,Josh Norris,3,0,0,0,0.0,
8479420,20242025,Tage Thompson,76,44,28,72,0.181818,24.46
8479420,20232024,Tage Thompson,71,29,27,56,0.117886,24.18
8479420,20222023,Tage Thompson,78,47,47,94,0.159322,34.18
8479420,20212022,Tage Thompson,78,38,30,68,0.15,26.09
8479420,20202021,Tage Thompson,38,8,6,14,0.083,10.1
8479420,20192020,Tage Thompson,1,0,0,0,0.0,
8479420,20182019,Tage Thompson,65,7,5,12,0.0648,
8479420,20172018,Tage Thompson,41,3,6,9,0.0545,
8477949,20242025,Alex Tuch,82,36,31,67,0.183673,31.87
8477949,20232024,Alex Tuch,75,22,37,59,0.114583,22.95
8477949,20222023,Alex Tuch,74,36,43,79,0.165138,28.9
8477949,20212022,Alex Tuch,50,12,26,38,0.086,16.46
8477949,20202021,Alex Tuch,55,18,15,33,0.127,17.99
8477949,20192020,Alex Tuch,42,8,9,17,0.082,
8477949,20182019,Alex Tuch,74,20,32,52,0.1111,
8477949,20172018,Alex Tuch,78,15,22,37,0.0877,
8477949,20162017,Alex Tuch,6,0,0,0,0.0,
8475722,20242025,Jason Zucker,73,21,32,53,0.146853,23.61
8475722,20232024,Jason Zucker,18,5,2,7,0.108696,18.62
8475722,20222023,Jason Zucker,78,27,21,48,0.137056,27.36
8475722,20212022,Jason Zucker,41,8,9,17,0.078,9.93
8475722,20202021,Jason Zucker,38,9,9,18,0.134,7.46
8475722,20192020,Jason Zucker,15,6,6,12,0.167,
8475722,20182019,Jason Zucker,81,21,21,42,0.0981,
8475722,20172018,Jason Zucker,82,33,31,64,0.1486,
8475722,20162017,Jason Zucker,79,22,25,47,0.1279,
8475722,20152016,Jason Zucker,71,13,10,23,0.0823,
8475722,20142015,Jason Zucker,51,21,5,26,0.1694,
8475722,20132014,Jason Zucker,21,4,1,5,0.1,
8475722,20122013,Jason Zucker,20,4,1,5,0.1176,
8475722,20112012,Jason Zucker,6,0,2,2,0.0,
8480196,20242025,Jacob Bryson,48,0,7,7,0.0,1.16
8480196,20232024,Jacob Bryson,36,1,7,8,0.066667,0.39
8480196,20222023,Jacob Bryson,59,1,8,9,0.037037,0.92
8480196,20212022,Jacob Bryson,73,1,9,10,0.023,1.69
8480196,20202021,Jacob Bryson,38,1,8,9,0.042,1.09
8481524,20242025,Bowen Byram,82,7,31,38,0.074468,8.81
8481524,20232024,Bowen Byram,18,3,6,9,0.142857,5.47
8481524,20222023,Bowen Byram,42,10,14,24,0.153846,6.45
8481524,20212022,Bowen Byram,30,5,12,17,0.102,2.72
8481524,20202021,Bowen Byram,19,0,2,2,0.0,0.88
8480839,20242025,Rasmus Dahlin,73,17,51,68,0.085,13.27
8480839,20232024,Rasmus Dahlin,81,20,39,59,0.085106,14.26
8480839,20222023,Rasmus Dahlin,78,15,58,73,0.073529,15.03
8480839,20212022,Rasmus Dahlin,80,13,40,53,0.076,7.68
8480839,20202021,Rasmus Dahlin,56,5,18,23,0.043,4.85
8480839,20192020,Rasmus Dahlin,59,4,36,40,0.044,
8480839,20182019,Rasmus Dahlin,82,9,35,44,0.0508,
8481708,20242025,Zac Jones,46,1,10,11,0.019608,2.61
8481708,20232024,Zac Jones,31,2,7,9,0.047619,1.64
8481708,20222023,Zac Jones,16,1,1,2,0.066667,0.54
8481708,20212022,Zac Jones,12,0,2,2,0.0,0.4
8481708,20202021,Zac Jones,10,0,4,4,0.0,0.32
8480807,20242025,Mattias Samuelsson,62,4,10,14,0.076923,1.88
8480807,20232024,Mattias Samuelsson,41,1,6,7,0.022727,1.23
8480807,20222023,Mattias Samuelsson,55,2,8,10,0.026316,4.15
8480807,20212022,Mattias Samuelsson,42,0,10,10,0.0,2.27
8480807,20202021,Mattias Samuelsson,12,0,2,2,0.0,0.19
8479982,20242025,Conor Timmins,17,1,6,7,0.055556,3.04
8479982,20232024,Conor Timmins,25,1,9,10,0.04,1.57
8479982,20222023,Conor Timmins,25,2,12,14,0.125,0.53
8479982,20212022,Conor Timmins,6,0,0,0,0.0,0.33
8479982,20202021,Conor Timmins,31,0,7,7,0.0,0.96
8479982,20192020,Conor Timmins,2,0,0,0,0.0,
8478427,20242025,Sebastian Aho,79,29,45,74,0.140097,24.86
8478427,20232024,Sebastian Aho,78,36,53,89,0.166667,27.18
8478427,20222023,Sebastian Aho,75,36,31,67,0.165138,32.97
8478427,20212022,Sebastian Aho,79,37,44,81,0.167,37.6
8478427,20202021,Sebastian Aho,56,24,33,57,0.162,18.55
8478427,20192020,Sebastian Aho,68,38,28,66,0.184,
8478427,20182019,Sebastian Aho,82,30,53,83,0.1235,
8478427,20172018,Sebastian Aho,78,29,36,65,0.145,
8478427,20162017,Sebastian Aho,82,24,25,49,0.1121,
8477478,20242025,William Carrier,43,4,7,11,0.083333,8.39
8477478,20232024,William Carrier,39,6,2,8,0.092308,8.13
8477478,20222023,William Carrier,56,16,9,25,0.135593,15.45
8477478,20212022,William Carrier,63,9,11,20,0.075,15.96
8477478,20202021,William Carrier,52,6,9,15,0.092,8.76
8477478,20192020,William Carrier,71,7,12,19,0.071,
8477478,20182019,William Carrier,54,8,1,9,0.0941,
8477478,20172018,William Carrier,37,1,2,3,0.0192,
8477478,20162017,William Carrier,41,5,3,8,0.1,
8477940,20242025,Nikolaj Ehlers,69,24,39,63,0.137931,19.82
8477940,20232024,Nikolaj Ehlers,82,25,36,61,0.107296,18.36
8477940,20222023,Nikolaj Ehlers,45,12,26,38,0.090909,11.67
8477940,20212022,Nikolaj Ehlers,62,28,27,55,0.114,22.68
8477940,20202021,Nikolaj Ehlers,47,21,25,46,0.142,12.73
8477940,20192020,Nikolaj Ehlers,71,25,33,58,0.123,
8477940,20182019,Nikolaj Ehlers,62,21,16,37,0.1329,
8477940,20172018,Nikolaj Ehlers,82,29,31,60,0.1255,
8477940,20162017,Nikolaj Ehlers,82,25,39,64,0.1225,
8477940,20152016,Nikolaj Ehlers,72,15,23,38,0.0898,
8475791,20242025,Taylor Hall,31,9,9,18,0.145161,15.62
8475791,20232024,Taylor Hall,10,2,2,4,0.1,1.47
8475791,20222023,Taylor Hall,61,16,20,36,0.106667,19.2
8475791,20212022,Taylor Hall,81,20,41,61,0.092,20.58
8475791,20202021,Taylor Hall,16,8,6,14,0.167,12.22
8475791,20192020,Taylor Hall,35,10,17,27,0.081,
8475791,20182019,Taylor Hall,33,11,26,37,0.0973,
8475791,20172018,Taylor Hall,76,39,54,93,0.1403,
8475791,20162017,Taylor Hall,72,20,33,53,0.084,
8475791,20152016,Taylor Hall,82,26,39,65,0.0909,
8475791,20142015,Taylor Hall,53,14,24,38,0.0886,
8475791,20132014,Taylor Hall,75,27,53,80,0.108,
8475791,20122013,Taylor Hall,45,16,34,50,0.1039,
8475791,20112012,Taylor Hall,61,27,26,53,0.1304,
8475791,20102011,Taylor Hall,65,22,20,42,0.1183,
8476873,20242025,Mark Jankowski,19,8,0,8,0.380952,10.89
8476873,20232024,Mark Jankowski,32,7,8,15,0.145833,8.03
8476873,20222023,Mark Jankowski,50,7,5,12,0.122807,6.57
8476873,20212022,Mark Jankowski,19,2,3,5,0.143,1.79
8476873,20202021,Mark Jankowski,45,4,7,11,0.114,4.47
8476873,20192020,Mark Jankowski,56,5,2,7,0.132,
8476873,20182019,Mark Jankowski,79,14,18,32,0.1414,
8476873,20172018,Mark Jankowski,72,17,8,25,0.1441,
8476873,20162017,Mark Jankowski,1,0,0,0,0.0,
8479370,20242025,Tyson Jost,39,4,5,9,0.090909,4.21
8479370,20232024,Tyson Jost,43,3,3,6,0.0625,4.39
8479370,20222023,Tyson Jost,59,7,15,22,0.079545,11.12
8479370,20212022,Tyson Jost,21,2,4,6,0.095,8.92
8479370,20202021,Tyson Jost,54,7,10,17,0.076,8.56
8479370,20192020,Tyson Jost,67,8,15,23,0.07,
8479370,20182019,Tyson Jost,70,11,15,26,0.0965,
8479370,20172018,Tyson Jost,65,12,10,22,0.1062,
8479370,20162017,Tyson Jost,6,1,0,1,0.1111,
8480829,20242025,Jesperi Kotkaniemi,78,12,21,33,0.104348,14.01
8480829,20232024,Jesperi Kotkaniemi,79,12,15,27,0.09375,14.47
8480829,20222023,Jesperi Kotkaniemi,82,18,25,43,0.139535,17.57
8480829,20212022,Jesperi Kotkaniemi,66,12,17,29,0.148,9.22
8480829,20202021,Jesperi Kotkaniemi,56,5,15,20,0.057,7.29
8480829,20192020,Jesperi Kotkaniemi,36,6,2,8,0.109,
8480829,20182019,Jesperi Kotkaniemi,79,11,23,34,0.0821,
8476921,20242025,Jordan Martinook,79,15,21,36,0.133929,18.83
8476921,20232024,Jordan Martinook,82,14,18,32,0.094595,17.54
8476921,20222023,Jordan Martinook,82,13,21,34,0.080247,20.54
8476921,20212022,Jordan Martinook,59,6,9,15,0.078,7.95
8476921,20202021,Jordan Martinook,44,4,9,13,0.065,7.6
8476921,20192020,Jordan Martinook,45,2,11,13,0.045,
8476921,20182019,Jordan Martinook,82,15,10,25,0.1027,
8476921,20172018,Jordan Martinook,81,6,9,15,0.0536,
8476921,20162017,Jordan Martinook,77,11,14,25,0.1009,
8476921,20152016,Jordan Martinook,81,9,15,24,0.0826,
8476921,20142015,Jordan Martinook,8,0,1,1,0.0,
8480762,20242025,Eric Robinson,82,14,18,32,0.127273,17.58
8480762,20232024,Eric Robinson,40,2,7,9,0.038462,8.74
8480762,20222023,Eric Robinson,72,12,12,24,0.122449,13.22
8480762,20212022,Eric Robinson,67,10,17,27,0.096,12.51
8480762,20202021,Eric Robinson,56,8,10,18,0.107,8.79
8480762,20192020,Eric Robinson,50,7,5,12,0.101,
8480762,20182019,Eric Robinson,13,0,0,0,0.0,
8480762,20172018,Eric Robinson,1,0,0,0,0.0,
8473533,20242025,Jordan Staal,75,13,23,36,0.121495,14.83
8473533,20232024,Jordan Staal,80,10,20,30,0.081301,15.22
8473533,20222023,Jordan Staal,81,17,17,34,0.137097,19.05
8473533,20212022,Jordan Staal,78,17,19,36,0.116,22.38
8473533,20202021,Jordan Staal,53,16,22,38,0.155,17.2
8473533,20192020,Jordan Staal,68,8,19,27,0.064,
8473533,20182019,Jordan Staal,50,11,17,28,0.0909,
8473533,20172018,Jordan Staal,79,19,27,46,0.1188,
8473533,20162017,Jordan Staal,75,16,29,45,0.0976,
8473533,20152016,Jordan Staal,82,20,28,48,0.1325,
8473533,20142015,Jordan Staal,46,6,18,24,0.0652,
8473533,20132014,Jordan Staal,82,15,25,40,0.0909,
8473533,20122013,Jordan Staal,48,10,21,31,0.0877,
8473533,20112012,Jordan Staal,62,25,25,50,0.1678,
8473533,20102011,Jordan Staal,42,11,19,30,0.1209,
8473533,20092010,Jordan Staal,82,21,28,49,0.1077,
8473533,20082009,Jordan Staal,82,22,27,49,0.1325,
8473533,20072008,Jordan Staal,82,12,16,28,0.0656,
8473533,20062007,Jordan Staal,81,29,13,42,0.2214,
8480830,20242025,Andrei Svechnikov,72,20,28,48,0.111111,25.59
8480830,20232024,Andrei Svechnikov,59,19,33,52,0.131944,19.57
8480830,20222023,Andrei Svechnikov,64,23,32,55,0.112195,24.46
8480830,20212022,Andrei Svechnikov,78,30,39,69,0.12,31.74
8480830,20202021,Andrei Svechnikov,55,15,27,42,0.102,18.75
8480830,20192020,Andrei Svechnikov,68,24,37,61,0.131,
8480830,20182019,Andrei Svechnikov,82,20,17,37,0.1058,
8478970,20242025,Jalen Chatfield,79,7,11,18,0.061404,4.56
8478970,20232024,Jalen Chatfield,72,8,14,22,0.088889,4.75
8478970,20222023,Jalen Chatfield,78,6,8,14,0.064516,4.9
8478970,20212022,Jalen Chatfield,16,0,3,3,0.0,1.05
8478970,20202021,Jalen Chatfield,18,0,1,1,0.0,0.35
8476906,20242025,Shayne Gostisbehere,70,7,38,45,0.057377,9.39
8476906,20232024,Shayne Gostisbehere,81,10,46,56,0.071942,9.49
8476906,20222023,Shayne Gostisbehere,23,3,7,10,0.075,12.94
8476906,20212022,Shayne Gostisbehere,82,14,37,51,0.093,7.2
8476906,20202021,Shayne Gostisbehere,41,9,11,20,0.106,4.09
8476906,20192020,Shayne Gostisbehere,42,5,7,12,0.068,
8476906,20182019,Shayne Gostisbehere,78,9,28,37,0.05,
8476906,20172018,Shayne Gostisbehere,78,13,52,65,0.0588,
8476906,20162017,Shayne Gostisbehere,76,7,32,39,0.0354,
8476906,20152016,Shayne Gostisbehere,64,17,29,46,0.1118,
8476906,20142015,Shayne Gostisbehere,2,0,0,0,0.0,
8480817,20242025,K'Andre Miller,74,7,20,27,0.063636,5.77
8480817,20232024,K'Andre Miller,80,8,22,30,0.083333,7.51
8480817,20222023,K'Andre Miller,79,9,34,43,0.079646,5.87
8480817,20212022,K'Andre Miller,82,7,13,20,0.069,5.11
8480817,20202021,K'Andre Miller,53,5,7,12,0.081,2.76
8476422,20242025,Mike Reilly,18,0,2,2,0.0,1.1
8476422,20232024,Mike Reilly,59,6,18,24,0.05042,5.36
8476422,20222023,Mike Reilly,10,0,1,1,0.0,0.58
8476422,20212022,Mike Reilly,70,4,13,17,0.03,5.5
8476422,20202021,Mike Reilly,15,0,8,8,0.0,2.69
8476422,20192020,Mike Reilly,30,1,11,12,0.016,
8476422,20182019,Mike Reilly,57,3,8,11,0.0297,
8476422,20172018,Mike Reilly,19,0,8,8,0.0,
8476422,20162017,Mike Reilly,17,1,0,1,0.0526,
8476422,20152016,Mike Reilly,29,1,6,7,0.037,
8476958,20242025,Jaccob Slavin,80,6,21,27,0.054545,7.27
8476958,20232024,Jaccob Slavin,81,6,31,37,0.039735,6.41
8476958,20222023,Jaccob Slavin,76,7,20,27,0.053435,7.49
8476958,20212022,Jaccob Slavin,79,4,38,42,0.024,8.67
8476958,20202021,Jaccob Slavin,52,3,12,15,0.03,4.62
8476958,20192020,Jaccob Slavin,68,6,30,36,0.041,
8476958,20182019,Jaccob Slavin,82,8,23,31,0.0548,
8476958,20172018,Jaccob Slavin,82,8,22,30,0.0519,
8476958,20162017,Jaccob Slavin,82,5,29,34,0.0505,
8476958,20152016,Jaccob Slavin,63,2,18,20,0.0238,
8480336,20242025,Sean Walker,82,5,11,16,0.034722,8.75
8480336,20232024,Sean Walker,18,4,3,7,0.097561,7.76
8480336,20222023,Sean Walker,70,3,10,13,0.031915,5.03
8480336,20212022,Sean Walker,6,0,2,2,0.0,1.04
8480336,20202021,Sean Walker,47,5,13,18,0.054,4.17
8480336,20192020,Sean Walker,70,5,19,24,0.039,
8480336,20182019,Sean Walker,39,3,7,10,0.0545,
8479944,20242025,Zachary Aston-Reese,79,6,11,17,0.059406,13.13
8479944,20232024,Zachary Aston-Reese,3,0,0,0,0.0,0.22
8479944,20222023,Zachary Aston-Reese,77,10,4,14,0.11236,10.69
8479944,20212022,Zachary Aston-Reese,17,3,1,4,0.115,8.18
8479944,20202021,Zachary Aston-Reese,45,9,6,15,0.114,8.67
8479944,20192020,Zachary Aston-Reese,57,6,7,13,0.061,
8479944,20182019,Zachary Aston-Reese,43,8,9,17,0.1053,
8479944,20172018,Zachary Aston-Reese,16,4,2,6,0.2,
8475745,20242025,Charlie Coyle,19,2,11,13,0.086957,13.78
8475745,20232024,Charlie Coyle,82,25,35,60,0.170068,22.41
8475745,20222023,Charlie Coyle,82,16,29,45,0.115108,15.52
8475745,20212022,Charlie Coyle,82,16,28,44,0.122,18.73
8475745,20202021,Charlie Coyle,51,6,10,16,0.076,6.76
8475745,20192020,Charlie Coyle,70,16,21,37,0.11,
8475745,20182019,Charlie Coyle,21,2,4,6,0.0476,
8475745,20172018,Charlie Coyle,66,11,26,37,0.094,
8475745,20162017,Charlie Coyle,82,18,38,56,0.1132,
8475745,20152016,Charlie Coyle,82,21,21,42,0.15,
8475745,20142015,Charlie Coyle,82,11,24,35,0.0917,
8475745,20132014,Charlie Coyle,70,12,18,30,0.0889,
8475745,20122013,Charlie Coyle,37,8,6,14,0.16,
8477392,20242025,Hudson Fasching,43,2,2,4,0.039216,5.59
8477392,20232024,Hudson Fasching,45,4,10,14,0.097561,4.71
8477392,20222023,Hudson Fasching,49,10,9,19,0.163934,9.3
8477392,20212022,Hudson Fasching,11,0,0,0,0.0,0.7
8477392,20202021,Hudson Fasching,5,0,0,0,0.0,1.19
8476867,20242025,Brendan Gaunce,12,0,1,1,0.0,1.03
8476867,20232024,Brendan Gaunce,24,2,2,4,0.083333,2.79
8476867,20222023,Brendan Gaunce,5,0,1,1,0.0,0.56
8476867,20212022,Brendan Gaunce,30,5,2,7,0.114,4.64
8476432,20242025,Boone Jenner,26,7,12,19,0.1,12.59
8476432,20232024,Boone Jenner,58,22,13,35,0.141935,21.01
8476432,20222023,Boone Jenner,68,26,19,45,0.121495,30.95
8476432,20212022,Boone Jenner,59,23,21,44,0.144,21.51
8476432,20202021,Boone Jenner,41,8,9,17,0.101,8.14
8476432,20192020,Boone Jenner,70,11,13,24,0.061,
8476432,20182019,Boone Jenner,77,16,22,38,0.0941,
8476432,20172018,Boone Jenner,75,13,19,32,0.0695,
8476432,20162017,Boone Jenner,82,18,16,34,0.0853,
8476432,20152016,Boone Jenner,82,30,19,49,0.1333,
8476432,20142015,Boone Jenner,31,9,8,17,0.1084,
8476432,20132014,Boone Jenner,72,16,13,29,0.126,
8480806,20242025,Isac Lundestrom,79,4,11,15,0.066667,8.62
8480806,20232024,Isac Lundestrom,46,5,6,11,0.131579,7.36
8480806,20222023,Isac Lundestrom,61,4,10,14,0.066667,6.39
8480806,20212022,Isac Lundestrom,80,16,13,29,0.193,11.7
8480806,20202021,Isac Lundestrom,41,6,3,9,0.115,5.45
8480806,20192020,Isac Lundestrom,15,0,4,4,0.0,
8480806,20182019,Isac Lundestrom,15,0,2,2,0.0,
8477497,20242025,Sean Monahan,54,19,38,57,0.148438,18.81
8477497,20232024,Sean Monahan,34,13,11,24,0.19403,24.8
8477497,20222023,Sean Monahan,25,6,11,17,0.109091,6.78
8477497,20212022,Sean Monahan,65,8,15,23,0.072,11.08
8477497,20202021,Sean Monahan,50,10,18,28,0.102,14.27
8477497,20192020,Sean Monahan,70,22,26,48,0.133,
8477497,20182019,Sean Monahan,78,34,48,82,0.1611,
8477497,20172018,Sean Monahan,74,31,33,64,0.1535,
8477497,20162017,Sean Monahan,82,27,31,58,0.1357,
8477497,20152016,Sean Monahan,81,27,36,63,0.1371,
8477497,20142015,Sean Monahan,81,31,31,62,0.1623,
8477497,20132014,Sean Monahan,75,22,12,34,0.1571,
8479671,20242025,Mathieu Olivier,82,18,14,32,0.162162,13.35
8479671,20232024,Mathieu Olivier,54,5,7,12,0.090909,6.54
8479671,20222023,Mathieu Olivier,66,5,10,15,0.066667,9.26
8479671,20212022,Mathieu Olivier,10,0,1,1,0.0,0.44
8479671,20202021,Mathieu Olivier,30,3,2,5,0.12,2.76
8479671,20192020,Mathieu Olivier,8,0,1,1,0.0,
8477425,20242025,Miles Wood,37,4,4,8,0.066667,6.83
8477425,20232024,Miles Wood,74,9,17,26,0.053892,21.07
8477425,20222023,Miles Wood,76,13,14,27,0.077844,15.63
8477425,20212022,Miles Wood,3,0,0,0,0.0,0.24
8477425,20202021,Miles Wood,55,17,8,25,0.134,13.36
8477425,20192020,Miles Wood,68,11,12,23,0.078,
8477425,20182019,Miles Wood,63,10,14,24,0.0629,
8477425,20172018,Miles Wood,76,19,13,32,0.1118,
8477425,20162017,Miles Wood,60,8,9,17,0.0762,
8477425,20152016,Miles Wood,1,0,0,0,0.0,
8479371,20242025,Dante Fabbro,62,9,17,26,0.109756,3.24
8479371,20232024,Dante Fabbro,56,3,10,13,0.046154,2.39
8479371,20222023,Dante Fabbro,79,2,9,11,0.019802,3.73
8479371,20212022,Dante Fabbro,66,3,21,24,0.034,3.52
8479371,20202021,Dante Fabbro,40,2,10,12,0.034,1.41
8479371,20192020,Dante Fabbro,64,5,6,11,0.054,
8479371,20182019,Dante Fabbro,4,1,0,1,0.2,
8475790,20242025,Erik Gudbranson,16,0,4,4,0.0,0.32
8475790,20232024,Erik Gudbranson,78,6,20,26,0.065934,2.48
8475790,20222023,Erik Gudbranson,70,1,12,13,0.009804,3.79
8475790,20212022,Erik Gudbranson,78,6,11,17,0.047,3.61
8475790,20202021,Erik Gudbranson,9,0,1,1,0.0,1.7
8475790,20192020,Erik Gudbranson,44,4,5,9,0.053,
8475790,20182019,Erik Gudbranson,19,0,2,2,0.0,
8475790,20172018,Erik Gudbranson,52,2,3,5,0.0377,
8475790,20162017,Erik Gudbranson,30,1,5,6,0.025,
8475790,20152016,Erik Gudbranson,64,2,7,9,0.0274,
8475790,20142015,Erik Gudbranson,76,4,9,13,0.0364,
8475790,20132014,Erik Gudbranson,65,3,6,9,0.0326,
8475790,20122013,Erik Gudbranson,32,0,4,4,0.0,
8475790,20112012,Erik Gudbranson,72,2,6,8,0.0263,
8478500,20242025,Ivan Provorov,82,7,26,33,0.07,5.55
8478500,20232024,Ivan Provorov,82,5,27,32,0.046729,5.18
8478500,20222023,Ivan Provorov,82,6,21,27,0.052174,5.82
8478500,20212022,Ivan Provorov,79,9,22,31,0.053,8.34
8478500,20202021,Ivan Provorov,56,7,19,26,0.056,6.06
8478500,20192020,Ivan Provorov,69,13,23,36,0.087,
8478500,20182019,Ivan Provorov,82,7,19,26,0.0483,
8478500,20172018,Ivan Provorov,82,17,24,41,0.0837,
8478500,20162017,Ivan Provorov,82,6,24,30,0.0373,
8476923,20242025,Damon Severson,70,6,19,25,0.065934,7.83
8476923,20232024,Damon Severson,67,9,19,28,0.102273,4.94
8476923,20222023,Damon Severson,81,7,26,33,0.068627,5.23
8476923,20212022,Damon Severson,80,11,35,46,0.07,10.96
8476923,20202021,Damon Severson,56,3,18,21,0.033,4.32
8476923,20192020,Damon Severson,69,8,23,31,0.07,
8476923,20182019,Damon Severson,82,11,28,39,0.0753,
8476923,20172018,Damon Severson,76,9,15,24,0.0744,
8476923,20162017,Damon Severson,80,3,28,31,0.024,
8476923,20152016,Damon Severson,72,1,20,21,0.0106,
8476923,20142015,Damon Severson,51,5,12,17,0.0538,
8478460,20242025,Zach Werenski,81,23,59,82,0.077181,19.45
8478460,20232024,Zach Werenski,70,11,46,57,0.054455,13.89
8478460,20222023,Zach Werenski,13,3,5,8,0.073171,1.79
8478460,20212022,Zach Werenski,68,11,37,48,0.051,13.65
8478460,20202021,Zach Werenski,35,7,13,20,0.089,4.2
8478460,20192020,Zach Werenski,63,20,21,41,0.107,
8478460,20182019,Zach Werenski,82,11,33,44,0.0655,
8478460,20172018,Zach Werenski,77,16,21,37,0.0773,
8478460,20162017,Zach Werenski,78,11,36,47,0.0585,
8474150,20242025,Mikael Backlund,76,15,17,32,0.085714,18.84
8474150,20232024,Mikael Backlund,82,15,24,39,0.07177,19.14
8474150,20222023,Mikael Backlund,82,19,37,56,0.073077,22.75
8474150,20212022,Mikael Backlund,82,12,27,39,0.056,18.8
8474150,20202021,Mikael Backlund,54,9,23,32,0.063,12.54
8474150,20192020,Mikael Backlund,70,16,29,45,0.102,
8474150,20182019,Mikael Backlund,77,21,26,47,0.1024,
8474150,20172018,Mikael Backlund,82,14,31,45,0.0654,
8474150,20162017,Mikael Backlund,81,22,31,53,0.1117,
8474150,20152016,Mikael Backlund,82,21,26,47,0.1355,
8474150,20142015,Mikael Backlund,52,10,17,27,0.0971,
8474150,20132014,Mikael Backlund,76,18,21,39,0.1011,
8474150,20122013,Mikael Backlund,32,8,8,16,0.0909,
8474150,20112012,Mikael Backlund,41,4,7,11,0.0471,
8474150,20102011,Mikael Backlund,73,10,15,25,0.0694,
8474150,20092010,Mikael Backlund,23,1,9,10,0.0213,
8474150,20082009,Mikael Backlund,1,0,0,0,0.0,
8478056,20242025,Clark Bishop,6,1,0,1,0.25,0.22
8476399,20242025,Blake Coleman,82,15,24,39,0.07732,26.11
8476399,20232024,Blake Coleman,78,30,24,54,0.157068,26.49
8476399,20222023,Blake Coleman,82,18,20,38,0.095745,27.12
8476399,20212022,Blake Coleman,81,16,17,33,0.075,20.8
8476399,20202021,Blake Coleman,55,14,17,31,0.115,13.76
8476399,20192020,Blake Coleman,9,0,1,1,0.0,
8476399,20182019,Blake Coleman,78,22,14,36,0.1033,
8476399,20172018,Blake Coleman,79,13,12,25,0.089,
8476399,20162017,Blake Coleman,23,1,1,2,0.0345,
8480797,20242025,Joel Farabee,31,3,3,6,0.057692,21.49
8480797,20232024,Joel Farabee,82,22,28,50,0.120879,18.84
8480797,20222023,Joel Farabee,82,15,24,39,0.103448,14.98
8480797,20212022,Joel Farabee,63,17,17,34,0.143,14.19
8480797,20202021,Joel Farabee,55,20,18,38,0.164,13.36
8480797,20192020,Joel Farabee,52,8,13,21,0.099,
8480028,20242025,Morgan Frost,32,3,9,12,0.051724,16.06
8480028,20232024,Morgan Frost,71,13,28,41,0.096296,14.69
8480028,20222023,Morgan Frost,81,19,27,46,0.122581,18.09
8480028,20212022,Morgan Frost,55,5,11,16,0.059,8.46
8480028,20202021,Morgan Frost,2,0,0,0,0.0,0.1
8480028,20192020,Morgan Frost,20,2,5,7,0.065,
8476456,20242025,Jonathan Huberdeau,81,28,34,62,0.183007,25.34
8476456,20232024,Jonathan Huberdeau,81,12,40,52,0.083916,18.39
8476456,20222023,Jonathan Huberdeau,79,15,40,55,0.119048,17.51
8476456,20212022,Jonathan Huberdeau,80,30,85,115,0.135,27.52
8476456,20202021,Jonathan Huberdeau,55,20,41,61,0.164,13.54
8476456,20192020,Jonathan Huberdeau,69,23,55,78,0.151,
8476456,20182019,Jonathan Huberdeau,82,30,62,92,0.1327,
8476456,20172018,Jonathan Huberdeau,82,27,42,69,0.1324,
8476456,20162017,Jonathan Huberdeau,31,10,16,26,0.1163,
8476456,20152016,Jonathan Huberdeau,76,20,39,59,0.1149,
8476456,20142015,Jonathan Huberdeau,79,15,39,54,0.0888,
8476456,20132014,Jonathan Huberdeau,69,9,19,28,0.0833,
8476456,20122013,Jonathan Huberdeau,48,14,17,31,0.125,
8478211,20242025,Dryden Hunt,5,0,3,3,0.0,0.58
8478211,20232024,Dryden Hunt,28,3,5,8,0.090909,2.96
8478211,20222023,Dryden Hunt,9,1,0,1,0.166667,3.16
8478211,20212022,Dryden Hunt,76,6,11,17,0.064,11.7
8478211,20202021,Dryden Hunt,26,3,5,8,0.077,3.33
8478211,20192020,Dryden Hunt,21,0,4,4,0.0,
8478211,20182019,Dryden Hunt,31,3,7,10,0.0566,
8478211,20172018,Dryden Hunt,11,0,1,1,0.0,
8475172,20242025,Nazem Kadri,82,35,32,67,0.125448,28.45
8475172,20232024,Nazem Kadri,82,29,46,75,0.104693,30.63
8475172,20222023,Nazem Kadri,82,24,32,56,0.089888,28.01
8475172,20212022,Nazem Kadri,71,28,59,87,0.113,29.41
8475172,20202021,Nazem Kadri,56,11,21,32,0.065,17.23
8475172,20192020,Nazem Kadri,51,19,17,36,0.143,
8475172,20182019,Nazem Kadri,73,16,28,44,0.087,
8475172,20172018,Nazem Kadri,80,32,23,55,0.1517,
8475172,20162017,Nazem Kadri,82,32,29,61,0.1356,
8475172,20152016,Nazem Kadri,76,17,28,45,0.0654,
8475172,20142015,Nazem Kadri,73,18,21,39,0.1023,
8475172,20132014,Nazem Kadri,78,20,30,50,0.1351,
8475172,20122013,Nazem Kadri,48,18,26,44,0.1682,
8475172,20112012,Nazem Kadri,21,5,2,7,0.1786,
8475172,20102011,Nazem Kadri,29,3,9,12,0.0588,
8475172,20092010,Nazem Kadri,1,0,0,0,0.0,
8479066,20242025,Ryan Lomberg,80,3,10,13,0.045455,5.78
8479066,20232024,Ryan Lomberg,75,5,2,7,0.073529,7.05
8479066,20222023,Ryan Lomberg,82,12,8,20,0.089552,14.07
8479066,20212022,Ryan Lomberg,55,9,9,18,0.099,9.36
8479066,20202021,Ryan Lomberg,34,2,2,4,0.043,3.88
8481068,20242025,Yegor Sharangovich,73,17,15,32,0.132813,17.75
8481068,20232024,Yegor Sharangovich,82,31,28,59,0.173184,20.79
8481068,20222023,Yegor Sharangovich,75,13,17,30,0.099237,17.25
8481068,20212022,Yegor Sharangovich,76,24,22,46,0.143,19.11
8481068,20202021,Yegor Sharangovich,54,16,14,30,0.14,11.08
8478397,20242025,Rasmus Andersson,81,11,20,31,0.067485,9.51
8478397,20232024,Rasmus Andersson,78,9,30,39,0.056604,7.93
8478397,20222023,Rasmus Andersson,79,11,38,49,0.069182,8.49
8478397,20212022,Rasmus Andersson,82,4,46,50,0.026,8.14
8478397,20202021,Rasmus Andersson,56,5,16,21,0.052,6.2
8478397,20192020,Rasmus Andersson,70,5,17,22,0.04,
8478397,20182019,Rasmus Andersson,79,2,17,19,0.0174,
8478397,20172018,Rasmus Andersson,10,0,0,0,0.0,
8478397,20162017,Rasmus Andersson,1,0,0,0,0.0,
8480860,20242025,Kevin Bahl,73,3,17,20,0.036585,3.39
8480860,20232024,Kevin Bahl,82,1,10,11,0.015873,2.27
8480860,20222023,Kevin Bahl,42,2,6,8,0.074074,1.21
8480860,20212022,Kevin Bahl,17,1,3,4,0.063,0.46
8480860,20202021,Kevin Bahl,7,0,2,2,0.0,0.08
8479402,20242025,Jake Bean,64,2,5,7,0.028169,2.82
8479402,20232024,Jake Bean,72,4,9,13,0.052632,3.66
8479402,20222023,Jake Bean,14,1,5,6,0.0625,0.72
8479402,20212022,Jake Bean,67,7,18,25,0.078,4.68
8479402,20202021,Jake Bean,42,1,11,12,0.018,2.79
8477810,20242025,Joel Hanley,53,2,7,9,0.047619,1.82
8477810,20232024,Joel Hanley,10,1,1,2,0.142857,1.08
8477810,20222023,Joel Hanley,26,0,2,2,0.0,0.54
8477810,20212022,Joel Hanley,44,2,4,6,0.111,0.72
8477810,20202021,Joel Hanley,35,0,8,8,0.0,0.82
8477810,20192020,Joel Hanley,8,0,2,2,0.0,
8477810,20182019,Joel Hanley,16,0,0,0,0.0,
8477810,20172018,Joel Hanley,5,0,0,0,0.0,
8477810,20162017,Joel Hanley,7,0,0,0,0.0,
8477810,20152016,Joel Hanley,10,0,6,6,0.0,
8477346,20242025,MacKenzie Weegar,81,8,39,47,0.043478,11.44
8477346,20232024,MacKenzie Weegar,82,20,32,52,0.096154,8.59
8477346,20222023,MacKenzie Weegar,81,4,27,31,0.025,6.63
8477346,20212022,MacKenzie Weegar,80,8,36,44,0.039,11.21
8477346,20202021,MacKenzie Weegar,54,6,30,36,0.059,4.44
8477346,20192020,MacKenzie Weegar,45,7,11,18,0.091,
8477346,20182019,MacKenzie Weegar,64,4,11,15,0.0506,
8477346,20172018,MacKenzie Weegar,60,2,6,8,0.0345,
8477346,20162017,MacKenzie Weegar,3,0,0,0,0.0,
8479315,20242025,Joey Anderson,18,0,1,1,0.0,1.69
8479315,20232024,Joey Anderson,55,5,12,17,0.087719,6.27
8479315,20222023,Joey Anderson,24,4,2,6,0.142857,4.15
8479315,20212022,Joey Anderson,5,0,0,0,0.0,0.66
8479315,20202021,Joey Anderson,1,0,0,0,0.0,0
8479315,20192020,Joey Anderson,18,4,2,6,0.19,
8479315,20182019,Joey Anderson,34,4,3,7,0.0816,
8477479,20242025,Tyler Bertuzzi,82,23,23,46,0.175573,24.9
8477479,20232024,Tyler Bertuzzi,80,21,22,43,0.13125,28.25
8477479,20222023,Tyler Bertuzzi,21,4,12,16,0.088889,11.97
8477479,20212022,Tyler Bertuzzi,68,30,32,62,0.167,26.52
8477479,20202021,Tyler Bertuzzi,9,5,2,7,0.25,4.45
8477479,20192020,Tyler Bertuzzi,71,21,27,48,0.163,
8477479,20182019,Tyler Bertuzzi,73,21,26,47,0.1603,
8477479,20172018,Tyler Bertuzzi,48,7,17,24,0.0843,
8477479,20162017,Tyler Bertuzzi,7,0,0,0,0.0,
8477444,20242025,Andre Burakovsky,79,10,27,37,0.086957,11.77
8477444,20232024,Andre Burakovsky,49,7,9,16,0.076087,8.76
8477444,20222023,Andre Burakovsky,49,13,26,39,0.12381,9.23
8477444,20212022,Andre Burakovsky,80,22,39,61,0.148,14.8
8477444,20202021,Andre Burakovsky,53,19,25,44,0.186,9.61
8477444,20192020,Andre Burakovsky,58,20,25,45,0.194,
8477444,20182019,Andre Burakovsky,76,12,13,25,0.12,
8477444,20172018,Andre Burakovsky,56,12,13,25,0.1429,
8477444,20162017,Andre Burakovsky,64,12,23,35,0.1081,
8477444,20152016,Andre Burakovsky,79,17,21,38,0.1349,
8477444,20142015,Andre Burakovsky,53,9,13,22,0.1385,
8477450,20242025,Jason Dickinson,59,7,9,16,0.125,8.18
8477450,20232024,Jason Dickinson,82,22,13,35,0.174603,13.07
8477450,20222023,Jason Dickinson,78,9,21,30,0.078947,13.17
8477450,20212022,Jason Dickinson,62,5,6,11,0.076,7.33
8477450,20202021,Jason Dickinson,51,7,8,15,0.106,6.18
8477450,20192020,Jason Dickinson,65,9,12,21,0.106,
8477450,20182019,Jason Dickinson,67,6,16,22,0.0638,
8477450,20172018,Jason Dickinson,27,0,2,2,0.0,
8477450,20162017,Jason Dickinson,10,2,0,2,0.2222,
8477450,20152016,Jason Dickinson,1,1,0,1,0.5,
8477987,20242025,Ryan Donato,80,31,31,62,0.17033,20.68
8477987,20232024,Ryan Donato,78,12,18,30,0.080537,13.87
8477987,20222023,Ryan Donato,71,14,13,27,0.114754,12.66
8477987,20212022,Ryan Donato,74,16,15,31,0.101,17.4
8477987,20202021,Ryan Donato,50,6,14,20,0.058,10.73
8477987,20192020,Ryan Donato,62,14,9,23,0.147,
8477987,20182019,Ryan Donato,22,4,12,16,0.0625,
8477987,20172018,Ryan Donato,12,5,4,9,0.2083,
8473422,20242025,Nick Foligno,78,15,20,35,0.144231,16.26
8473422,20232024,Nick Foligno,74,17,20,37,0.116438,22.21
8473422,20222023,Nick Foligno,60,10,16,26,0.140845,8.54
8473422,20212022,Nick Foligno,64,2,11,13,0.02,7.34
8473422,20202021,Nick Foligno,7,0,4,4,0.0,8.99
8473422,20192020,Nick Foligno,67,10,21,31,0.076,
8473422,20182019,Nick Foligno,73,17,18,35,0.1206,
8473422,20172018,Nick Foligno,72,15,18,33,0.1095,
8473422,20162017,Nick Foligno,79,26,25,51,0.1405,
8473422,20152016,Nick Foligno,72,12,25,37,0.0805,
8473422,20142015,Nick Foligno,79,31,42,73,0.1703,
8473422,20132014,Nick Foligno,70,18,21,39,0.1622,
8473422,20122013,Nick Foligno,45,6,13,19,0.087,
8473422,20112012,Nick Foligno,82,15,32,47,0.098,
8473422,20102011,Nick Foligno,82,14,20,34,0.094,
8473422,20092010,Nick Foligno,61,9,17,26,0.1084,
8473422,20082009,Nick Foligno,81,17,15,32,0.1172,
8473422,20072008,Nick Foligno,45,6,3,9,0.1364,
8478043,20242025,Sam Lafferty,60,4,3,7,0.08,4.5
8478043,20232024,Sam Lafferty,79,13,11,24,0.166667,11.38
8478043,20222023,Sam Lafferty,19,2,4,6,0.105263,11.28
8478043,20212022,Sam Lafferty,46,5,6,11,0.07,8.07
8478043,20202021,Sam Lafferty,34,0,6,6,0.0,2.71
8478043,20192020,Sam Lafferty,50,6,7,13,0.107,
8481624,20242025,Ilya Mikheyev,80,20,14,34,0.144928,16.3
8481624,20232024,Ilya Mikheyev,78,11,20,31,0.07483,15.71
8481624,20222023,Ilya Mikheyev,46,13,15,28,0.142857,10.03
8481624,20212022,Ilya Mikheyev,53,21,11,32,0.143,17.15
8481624,20202021,Ilya Mikheyev,54,7,10,17,0.065,12.18
8481624,20192020,Ilya Mikheyev,39,8,15,23,0.082,
8476882,20242025,Teuvo Teravainen,82,15,43,58,0.135135,11.23
8476882,20232024,Teuvo Teravainen,76,25,28,53,0.176056,17.22
8476882,20222023,Teuvo Teravainen,68,12,25,37,0.083333,12.32
8476882,20212022,Teuvo Teravainen,77,22,43,65,0.109,18.95
8476882,20202021,Teuvo Teravainen,21,5,10,15,0.102,4.95
8476882,20192020,Teuvo Teravainen,68,15,48,63,0.082,
8476882,20182019,Teuvo Teravainen,82,21,55,76,0.1257,
8476882,20172018,Teuvo Teravainen,82,23,41,64,0.1243,
8476882,20162017,Teuvo Teravainen,81,15,27,42,0.0888,
8476882,20152016,Teuvo Teravainen,78,13,22,35,0.0956,
8476882,20142015,Teuvo Teravainen,34,4,5,9,0.0606,
8476882,20132014,Teuvo Teravainen,3,0,0,0,0.0,
8476952,20242025,Dominic Toninato,5,0,0,0,0.0,0.08
8476952,20232024,Dominic Toninato,15,1,4,5,0.083333,2.22
8476952,20222023,Dominic Toninato,5,0,1,1,0.0,0.47
8476952,20212022,Dominic Toninato,77,7,7,14,0.159,6.85
8476952,20202021,Dominic Toninato,2,0,1,1,0.0,0.37
8476952,20192020,Dominic Toninato,46,4,7,11,0.105,
8476952,20182019,Dominic Toninato,2,1,0,1,1.0,
8476952,20172018,Dominic Toninato,37,0,2,2,0.0,
8476473,20242025,Connor Murphy,68,2,17,19,0.02381,3.57
8476473,20232024,Connor Murphy,46,2,6,8,0.039216,1.5
8476473,20222023,Connor Murphy,80,7,6,13,0.082353,3.31
8476473,20212022,Connor Murphy,57,4,6,10,0.056,2.04
8476473,20202021,Connor Murphy,50,3,12,15,0.038,2.25
8476473,20192020,Connor Murphy,58,5,14,19,0.043,
8476473,20182019,Connor Murphy,52,5,8,13,0.0595,
8476473,20172018,Connor Murphy,76,2,12,14,0.0183,
8476473,20162017,Connor Murphy,77,2,15,17,0.0247,
8476473,20152016,Connor Murphy,78,6,11,17,0.0594,
8476473,20142015,Connor Murphy,73,4,3,7,0.0556,
8476473,20132014,Connor Murphy,30,1,7,8,0.0333,
8479718,20242025,Alex Barré-Boulet,2,0,0,0,0.0,0
8479718,20232024,Alex Barré-Boulet,36,6,3,9,0.130435,6.75
8479718,20222023,Alex Barré-Boulet,1,0,0,0,0.0,0.15
8479718,20212022,Alex Barré-Boulet,14,3,2,5,0.188,1.91
8479718,20202021,Alex Barré-Boulet,15,3,0,3,0.115,2.86
8479525,20242025,Ross Colton,61,16,13,29,0.128,18.24
8479525,20232024,Ross Colton,80,17,23,40,0.116438,23.11
8479525,20222023,Ross Colton,81,16,16,32,0.104575,17.5
8479525,20212022,Ross Colton,79,22,17,39,0.138,19.41
8479525,20202021,Ross Colton,30,9,3,12,0.196,5.35
8480448,20242025,Parker Kelly,80,8,11,19,0.080808,10.18
8480448,20232024,Parker Kelly,80,8,10,18,0.093023,9.16
8480448,20222023,Parker Kelly,55,1,3,4,0.016949,5.87
8480448,20212022,Parker Kelly,41,7,5,12,0.146,5.64
8480448,20202021,Parker Kelly,1,1,0,1,1.0,0.08
8481641,20242025,Joel Kiviranta,79,16,7,23,0.190476,12.9
8481641,20232024,Joel Kiviranta,56,3,6,9,0.0625,6.06
8481641,20222023,Joel Kiviranta,70,8,1,9,0.094118,10.57
8481641,20212022,Joel Kiviranta,56,1,6,7,0.017,5.78
8481641,20202021,Joel Kiviranta,26,6,5,11,0.194,3.88
8481641,20192020,Joel Kiviranta,11,1,0,1,0.077,
8477476,20242025,Artturi Lehkonen,69,27,18,45,0.182432,27.54
8477476,20232024,Artturi Lehkonen,45,16,18,34,0.15534,17.82
8477476,20222023,Artturi Lehkonen,64,21,30,51,0.14,20.33
8477476,20212022,Artturi Lehkonen,16,6,3,9,0.133,19.43
8477476,20202021,Artturi Lehkonen,47,7,6,13,0.09,7.15
8477476,20192020,Artturi Lehkonen,70,13,14,27,0.093,
8477476,20182019,Artturi Lehkonen,82,11,20,31,0.0625,
8477476,20172018,Artturi Lehkonen,66,12,9,21,0.0732,
8477476,20162017,Artturi Lehkonen,73,18,10,28,0.1139,
8477492,20242025,Nathan MacKinnon,79,32,84,116,0.1,29.52
8477492,20232024,Nathan MacKinnon,82,51,89,140,0.125926,37.26
8477492,20222023,Nathan MacKinnon,71,42,69,111,0.114754,30.83
8477492,20212022,Nathan MacKinnon,65,32,56,88,0.107,28.36
8477492,20202021,Nathan MacKinnon,48,20,45,65,0.097,18.74
8477492,20192020,Nathan MacKinnon,69,35,58,93,0.11,
8477492,20182019,Nathan MacKinnon,82,41,58,99,0.1123,
8477492,20172018,Nathan MacKinnon,74,39,58,97,0.1373,
8477492,20162017,Nathan MacKinnon,82,16,37,53,0.0637,
8477492,20152016,Nathan MacKinnon,72,21,31,52,0.0857,
8477492,20142015,Nathan MacKinnon,64,14,24,38,0.0729,
8477492,20132014,Nathan MacKinnon,82,24,39,63,0.0996,
8480039,20242025,Martin Necas,30,11,17,28,0.135802,23.09
8480039,20232024,Martin Necas,77,24,29,53,0.103896,22.42
8480039,20222023,Martin Necas,82,28,43,71,0.116667,26.9
8480039,20212022,Martin Necas,78,14,26,40,0.088,14.1
8480039,20202021,Martin Necas,53,14,27,41,0.123,13.27
8480039,20192020,Martin Necas,64,16,20,36,0.182,
8480039,20182019,Martin Necas,7,1,1,2,0.1667,
8480039,20172018,Martin Necas,1,0,0,0,0.0,
8475754,20242025,Brock Nelson,19,6,7,13,0.193548,22.21
8475754,20232024,Brock Nelson,82,34,35,69,0.136,27.82
8475754,20222023,Brock Nelson,82,36,39,75,0.162162,29.32
8475754,20212022,Brock Nelson,72,37,22,59,0.216,19.8
8475754,20202021,Brock Nelson,56,18,15,33,0.149,19.81
8475754,20192020,Brock Nelson,68,26,28,54,0.149,
8475754,20182019,Brock Nelson,82,25,28,53,0.1381,
8475754,20172018,Brock Nelson,82,19,16,35,0.1377,
8475754,20162017,Brock Nelson,81,20,25,45,0.1156,
8475754,20152016,Brock Nelson,81,26,14,40,0.1576,
8475754,20142015,Brock Nelson,82,20,22,42,0.1053,
8475754,20132014,Brock Nelson,72,14,12,26,0.1061,
8477501,20242025,Valeri Nichushkin,43,21,13,34,0.177966,18.68
8477501,20232024,Valeri Nichushkin,54,28,25,53,0.177215,27.25
8477501,20222023,Valeri Nichushkin,53,17,30,47,0.107595,20.48
8477501,20212022,Valeri Nichushkin,62,25,27,52,0.139,24.62
8477501,20202021,Valeri Nichushkin,55,10,11,21,0.102,9.11
8477501,20192020,Valeri Nichushkin,65,13,14,27,0.115,
8477501,20182019,Valeri Nichushkin,57,0,10,10,0.0,
8481186,20242025,Logan O'Connor,80,10,11,21,0.11236,11.96
8481186,20232024,Logan O'Connor,57,13,12,25,0.152941,13.47
8481186,20222023,Logan O'Connor,82,9,17,26,0.086538,13.17
8481186,20212022,Logan O'Connor,81,8,16,24,0.063,12.23
8481186,20202021,Logan O'Connor,22,3,2,5,0.081,5.52
8481186,20192020,Logan O'Connor,16,2,0,2,0.133,
8481186,20182019,Logan O'Connor,5,0,0,0,0.0,
8478109,20242025,Victor Olofsson,56,15,14,29,0.137615,11.78
8478109,20232024,Victor Olofsson,51,7,8,15,0.106061,5.35
8478109,20222023,Victor Olofsson,75,28,12,40,0.173913,20.21
8478109,20212022,Victor Olofsson,72,20,29,49,0.122,16.62
8478109,20202021,Victor Olofsson,56,13,19,32,0.101,11.74
8478109,20192020,Victor Olofsson,54,20,22,42,0.157,
8478109,20182019,Victor Olofsson,6,2,2,4,0.0952,
8470613,20242025,Brent Burns,82,6,23,29,0.034483,7.11
8470613,20232024,Brent Burns,82,10,33,43,0.054054,9.89
8470613,20222023,Brent Burns,82,18,43,61,0.070588,12.08
8470613,20212022,Brent Burns,82,10,44,54,0.049,9.2
8470613,20202021,Brent Burns,56,7,22,29,0.051,8.97
8470613,20192020,Brent Burns,70,12,33,45,0.053,
8470613,20182019,Brent Burns,82,16,67,83,0.0533,
8470613,20172018,Brent Burns,82,12,55,67,0.0361,
8470613,20162017,Brent Burns,82,29,47,76,0.0906,
8470613,20152016,Brent Burns,82,27,48,75,0.0765,
8470613,20142015,Brent Burns,82,17,43,60,0.0694,
8470613,20132014,Brent Burns,69,22,26,48,0.0898,
8470613,20122013,Brent Burns,30,9,11,20,0.1111,
8470613,20112012,Brent Burns,81,11,26,37,0.0547,
8470613,20102011,Brent Burns,80,17,29,46,0.1,
8470613,20092010,Brent Burns,47,3,17,20,0.0288,
8470613,20082009,Brent Burns,59,8,19,27,0.0544,
8470613,20072008,Brent Burns,82,15,28,43,0.0949,
8470613,20062007,Brent Burns,77,7,18,25,0.0648,
8470613,20052006,Brent Burns,72,4,12,16,0.0548,
8479398,20242025,Samuel Girard,73,3,21,24,0.031579,3.88
8479398,20232024,Samuel Girard,59,3,15,18,0.041096,3.85
8479398,20222023,Samuel Girard,76,6,31,37,0.05042,5.38
8479398,20212022,Samuel Girard,67,5,23,28,0.063,3.14
8479398,20202021,Samuel Girard,48,5,27,32,0.063,2.94
8479398,20192020,Samuel Girard,70,4,30,34,0.042,
8479398,20182019,Samuel Girard,82,4,23,27,0.0345,
8479398,20172018,Samuel Girard,68,3,17,20,0.0395,
8480069,20242025,Cale Makar,80,30,62,92,0.121951,20.33
8480069,20232024,Cale Makar,77,21,69,90,0.090909,16.43
8480069,20222023,Cale Makar,60,17,49,66,0.096591,12.26
8480069,20212022,Cale Makar,77,28,58,86,0.117,15.02
8480069,20202021,Cale Makar,44,8,36,44,0.077,5.26
8480069,20192020,Cale Makar,57,12,38,50,0.099,
8476312,20242025,Josh Manson,48,1,14,15,0.015385,2.07
8476312,20232024,Josh Manson,76,8,17,25,0.065041,6.24
8476312,20222023,Josh Manson,27,2,8,10,0.04878,2.07
8476312,20212022,Josh Manson,22,2,5,7,0.065,4.67
8476312,20202021,Josh Manson,23,1,6,7,0.053,0.65
8476312,20192020,Josh Manson,50,1,8,9,0.016,
8476312,20182019,Josh Manson,74,3,13,16,0.0313,
8476312,20172018,Josh Manson,80,7,30,37,0.0598,
8476312,20162017,Josh Manson,82,5,12,17,0.0568,
8476312,20152016,Josh Manson,71,5,10,15,0.0568,
8476312,20142015,Josh Manson,28,0,3,3,0.0,
8478038,20242025,Devon Toews,76,10,34,44,0.072464,8.27
8478038,20232024,Devon Toews,82,12,38,50,0.075472,9.09
8478038,20222023,Devon Toews,80,7,43,50,0.042424,7.93
8478038,20212022,Devon Toews,66,13,44,57,0.082,9.33
8478038,20202021,Devon Toews,53,9,22,31,0.074,6.27
8478038,20192020,Devon Toews,68,6,22,28,0.049,
8478038,20182019,Devon Toews,48,5,13,18,0.0617,
8479414,20242025,Nathan Bastian,59,4,6,10,0.090909,7.42
8479414,20232024,Nathan Bastian,54,5,7,12,0.087719,9.11
8479414,20222023,Nathan Bastian,43,6,9,15,0.096774,9.89
8479414,20212022,Nathan Bastian,60,11,5,16,0.126,15.08
8479414,20202021,Nathan Bastian,41,3,7,10,0.065,5.42
8473994,20242025,Jamie Benn,80,16,33,49,0.117647,17.97
8473994,20232024,Jamie Benn,82,21,39,60,0.128049,24.25
8473994,20222023,Jamie Benn,82,33,45,78,0.173684,28.32
8473994,20212022,Jamie Benn,82,18,28,46,0.099,23.58
8473994,20202021,Jamie Benn,52,11,24,35,0.089,12.67
8473994,20192020,Jamie Benn,69,19,20,39,0.117,
8473994,20182019,Jamie Benn,78,27,26,53,0.1429,
8473994,20172018,Jamie Benn,82,36,43,79,0.1494,
8473994,20162017,Jamie Benn,77,26,43,69,0.1294,
8473994,20152016,Jamie Benn,82,41,48,89,0.166,
8473994,20142015,Jamie Benn,82,35,52,87,0.1383,
8473994,20132014,Jamie Benn,81,34,45,79,0.1219,
8473994,20122013,Jamie Benn,41,12,21,33,0.1091,
8473994,20112012,Jamie Benn,71,26,37,63,0.1281,
8473994,20102011,Jamie Benn,69,22,34,56,0.1243,
8473994,20092010,Jamie Benn,82,22,19,41,0.1209,
8476278,20242025,Colin Blackwell,63,6,11,17,0.095238,6.69
8476278,20232024,Colin Blackwell,44,8,4,12,0.090909,9
8476278,20222023,Colin Blackwell,53,2,8,10,0.037736,5.77
8476278,20212022,Colin Blackwell,19,2,1,3,0.125,7.71
8476278,20202021,Colin Blackwell,47,12,10,22,0.188,7.52
8476278,20192020,Colin Blackwell,27,3,7,10,0.097,
8476278,20182019,Colin Blackwell,6,0,0,0,0.0,
8475168,20242025,Matt Duchene,82,30,52,82,0.197368,21.23
8475168,20232024,Matt Duchene,80,25,40,65,0.145349,25.29
8475168,20222023,Matt Duchene,71,22,34,56,0.130952,20.49
8475168,20212022,Matt Duchene,78,43,43,86,0.189,34.82
8475168,20202021,Matt Duchene,34,6,7,13,0.082,8.75
8475168,20192020,Matt Duchene,66,13,29,42,0.096,
8475168,20182019,Matt Duchene,23,4,8,12,0.087,
8475168,20172018,Matt Duchene,68,23,26,49,0.1377,
8475168,20162017,Matt Duchene,77,18,23,41,0.1125,
8475168,20152016,Matt Duchene,76,30,29,59,0.15,
8475168,20142015,Matt Duchene,82,21,34,55,0.1014,
8475168,20132014,Matt Duchene,71,23,47,70,0.106,
8475168,20122013,Matt Duchene,47,17,26,43,0.1288,
8475168,20112012,Matt Duchene,58,14,14,28,0.1061,
8475168,20102011,Matt Duchene,80,27,40,67,0.1337,
8475168,20092010,Matt Duchene,81,24,31,55,0.1333,
8476889,20242025,Radek Faksa,70,5,10,15,0.073529,6.64
8476889,20232024,Radek Faksa,74,7,12,19,0.098592,11.25
8476889,20222023,Radek Faksa,81,11,9,20,0.125,11.97
8476889,20212022,Radek Faksa,77,5,14,19,0.056,11.9
8476889,20202021,Radek Faksa,55,6,8,14,0.064,9.08
8476889,20192020,Radek Faksa,66,11,9,20,0.101,
8476889,20182019,Radek Faksa,81,15,15,30,0.1316,
8476889,20172018,Radek Faksa,79,17,16,33,0.1441,
8476889,20162017,Radek Faksa,80,12,21,33,0.0909,
8476889,20152016,Radek Faksa,45,5,7,12,0.0746,
8478449,20242025,Roope Hintz,76,28,39,67,0.175,27.45
8478449,20232024,Roope Hintz,80,30,35,65,0.164835,28.71
8478449,20222023,Roope Hintz,73,37,38,75,0.201087,28.69
8478449,20212022,Roope Hintz,80,37,35,72,0.174,32.46
8478449,20202021,Roope Hintz,41,15,28,43,0.163,12.38
8478449,20192020,Roope Hintz,60,19,14,33,0.158,
8478449,20182019,Roope Hintz,58,9,13,22,0.0909,
8478420,20242025,Mikko Rantanen,20,5,13,18,0.135135,36.26
8478420,20232024,Mikko Rantanen,80,42,62,104,0.154982,33.51
8478420,20222023,Mikko Rantanen,82,55,50,105,0.179739,38.53
8478420,20212022,Mikko Rantanen,75,36,56,92,0.142,30.68
8478420,20202021,Mikko Rantanen,52,30,36,66,0.169,22.19
8478420,20192020,Mikko Rantanen,42,19,22,41,0.178,
8478420,20182019,Mikko Rantanen,74,31,56,87,0.1606,
8478420,20172018,Mikko Rantanen,81,29,55,84,0.1629,
8478420,20162017,Mikko Rantanen,75,20,18,38,0.1504,
8478420,20152016,Mikko Rantanen,9,0,0,0,0.0,
8480027,20242025,Jason Robertson,82,35,45,80,0.165877,23.29
8480027,20232024,Jason Robertson,82,29,51,80,0.125541,24.17
8480027,20222023,Jason Robertson,82,46,63,109,0.146965,30.92
8480027,20212022,Jason Robertson,74,41,38,79,0.186,30.15
8480027,20202021,Jason Robertson,51,17,28,45,0.134,10.55
8480027,20192020,Jason Robertson,3,0,1,1,0.0,
8475794,20242025,Tyler Seguin,20,9,12,21,0.195652,8.21
8475794,20232024,Tyler Seguin,68,25,27,52,0.162338,19.97
8475794,20222023,Tyler Seguin,76,21,29,50,0.111111,24.02
8475794,20212022,Tyler Seguin,81,24,25,49,0.11,22.88
8475794,20202021,Tyler Seguin,3,2,0,2,0.25,0.84
8475794,20192020,Tyler Seguin,69,17,33,50,0.069,
8475794,20182019,Tyler Seguin,82,33,47,80,0.0988,
8475794,20172018,Tyler Seguin,82,40,38,78,0.1194,
8475794,20162017,Tyler Seguin,82,26,46,72,0.0864,
8475794,20152016,Tyler Seguin,72,33,40,73,0.1187,
8475794,20142015,Tyler Seguin,71,37,40,77,0.1321,
8475794,20132014,Tyler Seguin,80,37,47,84,0.1259,
8475794,20122013,Tyler Seguin,48,16,16,32,0.0994,
8475794,20112012,Tyler Seguin,81,29,38,67,0.1198,
8475794,20102011,Tyler Seguin,74,11,11,22,0.084,
8479351,20242025,Sam Steel,79,6,19,25,0.067416,8.6
8479351,20232024,Sam Steel,77,9,15,24,0.104651,10.3
8479351,20222023,Sam Steel,65,10,18,28,0.117647,10.62
8479351,20212022,Sam Steel,68,6,14,20,0.091,6.86
8479351,20202021,Sam Steel,42,6,6,12,0.143,4.79
8479351,20192020,Sam Steel,65,6,16,22,0.071,
8479351,20182019,Sam Steel,22,6,5,11,0.1818,
8478476,20242025,Kyle Capobianco,1,0,0,0,0.0,0.01
8480036,20242025,Miro Heiskanen,50,5,20,25,0.046296,7.35
8480036,20232024,Miro Heiskanen,71,9,45,54,0.055556,9.82
8480036,20222023,Miro Heiskanen,79,11,62,73,0.053398,12.06
8480036,20212022,Miro Heiskanen,70,5,31,36,0.032,9.92
8480036,20202021,Miro Heiskanen,55,8,19,27,0.066,7.71
8480036,20192020,Miro Heiskanen,68,8,27,35,0.049,
8480036,20182019,Miro Heiskanen,82,12,21,33,0.0659,
8476902,20242025,Esa Lindell,80,5,21,26,0.050505,7.2
8476902,20232024,Esa Lindell,82,5,21,26,0.04386,5.82
8476902,20222023,Esa Lindell,82,8,16,24,0.068966,6.6
8476902,20212022,Esa Lindell,76,4,21,25,0.029,4.91
8476902,20202021,Esa Lindell,56,5,11,16,0.05,3.8
8476902,20192020,Esa Lindell,69,3,20,23,0.031,
8476902,20182019,Esa Lindell,82,11,21,32,0.0833,
8476902,20172018,Esa Lindell,80,7,20,27,0.0511,
8476902,20162017,Esa Lindell,73,6,12,18,0.0606,
8476902,20152016,Esa Lindell,4,0,0,0,0.0,
8480950,20242025,Ilya Lyubushkin,80,1,13,14,0.019608,2.33
8480950,20232024,Ilya Lyubushkin,19,0,4,4,0.0,2.71
8480950,20222023,Ilya Lyubushkin,68,2,12,14,0.04878,1.36
8480950,20212022,Ilya Lyubushkin,31,2,4,6,0.095,1.91
8480950,20202021,Ilya Lyubushkin,42,1,1,2,0.028,0.94
8480950,20192020,Ilya Lyubushkin,51,0,4,4,0.0,
8480950,20182019,Ilya Lyubushkin,41,0,4,4,0.0,
8475755,20242025,Alexander Petrovic,5,0,0,0,0.0,0.35
8475755,20232024,Alexander Petrovic,1,0,0,0,0.0,0.12
8478891,20242025,Mason Appleton,71,10,12,22,0.093458,10.88
8478891,20232024,Mason Appleton,82,14,22,36,0.114754,13.74
8478891,20222023,Mason Appleton,41,5,11,16,0.070423,7.51
8478891,20212022,Mason Appleton,19,2,2,4,0.067,11.27
8478891,20202021,Mason Appleton,56,12,13,25,0.136,9.45
8478891,20192020,Mason Appleton,46,5,3,8,0.091,
8478891,20182019,Mason Appleton,36,3,7,10,0.1034,
8477456,20242025,J.T. Compher,76,11,21,32,0.112245,15.58
8477456,20232024,J.T. Compher,77,19,29,48,0.175926,17.18
8477456,20222023,J.T. Compher,82,17,35,52,0.11039,18.6
8477456,20212022,J.T. Compher,70,18,15,33,0.176,16.66
8477456,20202021,J.T. Compher,48,10,8,18,0.213,5.27
8477456,20192020,J.T. Compher,67,11,20,31,0.104,
8477456,20182019,J.T. Compher,66,16,16,32,0.1356,
8477456,20172018,J.T. Compher,69,13,10,23,0.0992,
8477456,20162017,J.T. Compher,21,3,2,5,0.1,
8477429,20242025,Andrew Copp,56,10,13,23,0.147059,12.34
8477429,20232024,Andrew Copp,79,13,20,33,0.119266,14.71
8477429,20222023,Andrew Copp,82,9,33,42,0.075,13.62
8477429,20212022,Andrew Copp,16,8,10,18,0.25,23.24
8477429,20202021,Andrew Copp,55,15,24,39,0.13,18.15
8477429,20192020,Andrew Copp,63,10,16,26,0.083,
8477429,20182019,Andrew Copp,69,11,14,25,0.1341,
8477429,20172018,Andrew Copp,82,9,19,28,0.0938,
8477429,20162017,Andrew Copp,64,9,8,17,0.1169,
8477429,20152016,Andrew Copp,77,7,6,13,0.1296,
8477429,20142015,Andrew Copp,1,0,1,1,0.0,
8479337,20242025,Alex DeBrincat,82,39,31,70,0.159836,32.1
8479337,20232024,Alex DeBrincat,82,27,40,67,0.113924,27.01
8479337,20222023,Alex DeBrincat,82,27,39,66,0.102662,28.32
8479337,20212022,Alex DeBrincat,82,41,37,78,0.152,31.16
8479337,20202021,Alex DeBrincat,52,32,24,56,0.206,20.01
8479337,20192020,Alex DeBrincat,70,18,27,45,0.087,
8479337,20182019,Alex DeBrincat,82,41,35,76,0.1864,
8479337,20172018,Alex DeBrincat,82,28,24,52,0.1547,
8474141,20242025,Patrick Kane,72,21,38,59,0.12,18.94
8474141,20232024,Patrick Kane,50,20,27,47,0.136054,11.69
8474141,20222023,Patrick Kane,19,5,7,12,0.111111,18.08
8474141,20212022,Patrick Kane,78,26,66,92,0.091,21.26
8474141,20202021,Patrick Kane,56,15,51,66,0.079,12.92
8474141,20192020,Patrick Kane,70,33,51,84,0.12,
8474141,20182019,Patrick Kane,81,44,66,110,0.129,
8474141,20172018,Patrick Kane,82,27,49,76,0.0947,
8474141,20162017,Patrick Kane,82,34,55,89,0.1164,
8474141,20152016,Patrick Kane,82,46,60,106,0.1603,
8474141,20142015,Patrick Kane,61,27,37,64,0.1452,
8474141,20132014,Patrick Kane,69,29,40,69,0.1278,
8474141,20122013,Patrick Kane,47,23,32,55,0.1667,
8474141,20112012,Patrick Kane,82,23,43,66,0.0909,
8474141,20102011,Patrick Kane,73,27,46,73,0.125,
8474141,20092010,Patrick Kane,82,30,58,88,0.1149,
8474141,20082009,Patrick Kane,80,25,45,70,0.0984,
8474141,20072008,Patrick Kane,82,21,51,72,0.1099,
8477946,20242025,Dylan Larkin,82,30,40,70,0.128205,33.97
8477946,20232024,Dylan Larkin,68,33,36,69,0.149321,27.95
8477946,20222023,Dylan Larkin,80,32,47,79,0.131148,27.39
8477946,20212022,Dylan Larkin,71,31,38,69,0.146,23.52
8477946,20202021,Dylan Larkin,44,9,14,23,0.067,11.95
8477946,20192020,Dylan Larkin,71,19,34,53,0.085,
8477946,20182019,Dylan Larkin,76,32,41,73,0.1115,
8477946,20172018,Dylan Larkin,82,16,47,63,0.069,
8477946,20162017,Dylan Larkin,80,17,15,32,0.0955,
8477946,20152016,Dylan Larkin,80,23,22,45,0.1041,
8479992,20242025,Michael Rasmussen,77,11,10,21,0.111111,16.97
8479992,20232024,Michael Rasmussen,75,13,20,33,0.128713,15.66
8479992,20222023,Michael Rasmussen,56,10,19,29,0.113636,14.92
8479992,20212022,Michael Rasmussen,80,15,12,27,0.117,16.63
8479992,20202021,Michael Rasmussen,40,3,9,12,0.048,7.45
8474037,20242025,James van Riemsdyk,71,16,20,36,0.188235,13.45
8474037,20232024,James van Riemsdyk,71,11,27,38,0.077465,22.72
8474037,20222023,James van Riemsdyk,61,12,17,29,0.10084,15.35
8474037,20212022,James van Riemsdyk,82,24,14,38,0.129,28
8474037,20202021,James van Riemsdyk,56,17,26,43,0.129,16.69
8474037,20192020,James van Riemsdyk,66,19,21,40,0.126,
8474037,20182019,James van Riemsdyk,66,27,21,48,0.1617,
8474037,20172018,James van Riemsdyk,81,36,18,54,0.1452,
8474037,20162017,James van Riemsdyk,82,29,33,62,0.1218,
8474037,20152016,James van Riemsdyk,40,14,15,29,0.1085,
8474037,20142015,James van Riemsdyk,82,27,29,56,0.1089,
8474037,20132014,James van Riemsdyk,80,30,31,61,0.1075,
8474037,20122013,James van Riemsdyk,48,18,14,32,0.1286,
8474037,20112012,James van Riemsdyk,43,11,13,24,0.0909,
8474037,20102011,James van Riemsdyk,75,21,19,40,0.1214,
8474037,20092010,James van Riemsdyk,78,15,20,35,0.0867,
8475766,20242025,Austin Watson,13,3,0,3,0.230769,1.15
8475766,20232024,Austin Watson,33,2,2,4,0.117647,1.47
8475766,20222023,Austin Watson,75,9,2,11,0.113924,8.38
8475766,20212022,Austin Watson,67,10,6,16,0.114,8.85
8475766,20202021,Austin Watson,34,3,7,10,0.073,3.5
8475766,20192020,Austin Watson,53,6,8,14,0.12,
8475766,20182019,Austin Watson,37,7,9,16,0.1094,
8475766,20172018,Austin Watson,76,14,5,19,0.1458,
8475766,20162017,Austin Watson,77,5,12,17,0.0556,
8475766,20152016,Austin Watson,57,3,7,10,0.0545,
8480879,20242025,Jacob Bernard-Docker,15,1,3,4,0.071429,1.11
8480879,20232024,Jacob Bernard-Docker,72,4,10,14,0.078431,1.71
8480879,20222023,Jacob Bernard-Docker,19,0,1,1,0.0,1.1
8480879,20212022,Jacob Bernard-Docker,8,0,1,1,0.0,0.27
8480879,20202021,Jacob Bernard-Docker,5,0,0,0,0.0,0.17
8475279,20242025,Ben Chiarot,81,4,9,13,0.036697,4.21
8475279,20232024,Ben Chiarot,77,5,15,20,0.046729,4.92
8475279,20222023,Ben Chiarot,76,5,14,19,0.045455,4.79
8475279,20212022,Ben Chiarot,20,2,6,8,0.043,6.13
8475279,20202021,Ben Chiarot,41,1,6,7,0.012,2.88
8475279,20192020,Ben Chiarot,69,9,12,21,0.069,
8475279,20182019,Ben Chiarot,78,5,15,20,0.045,
8475279,20172018,Ben Chiarot,57,2,12,14,0.0351,
8475279,20162017,Ben Chiarot,59,2,10,12,0.0408,
8475279,20152016,Ben Chiarot,70,1,9,10,0.0135,
8475279,20142015,Ben Chiarot,40,2,6,8,0.0541,
8475279,20132014,Ben Chiarot,1,0,0,0,0.0,
8476979,20242025,Erik Gustafsson,60,2,16,18,0.029851,3.41
8476979,20232024,Erik Gustafsson,76,6,25,31,0.064516,4.58
8476979,20222023,Erik Gustafsson,9,0,4,4,0.0,6.48
8476979,20212022,Erik Gustafsson,59,3,15,18,0.038,3.17
8476979,20202021,Erik Gustafsson,5,0,2,2,0.0,1.13
8476979,20192020,Erik Gustafsson,7,0,3,3,0.0,
8476979,20182019,Erik Gustafsson,79,17,43,60,0.1063,
8476979,20172018,Erik Gustafsson,35,5,11,16,0.0704,
8474612,20242025,Travis Hamonic,59,1,6,7,0.013889,2.7
8474612,20232024,Travis Hamonic,48,2,4,6,0.04,1.36
8474612,20222023,Travis Hamonic,75,6,15,21,0.044118,4.88
8474612,20212022,Travis Hamonic,19,1,2,3,0.032,3.08
8474612,20202021,Travis Hamonic,38,3,7,10,0.038,2.21
8474612,20192020,Travis Hamonic,50,3,9,12,0.036,
8474612,20182019,Travis Hamonic,69,7,12,19,0.0547,
8474612,20172018,Travis Hamonic,74,1,10,11,0.0093,
8474612,20162017,Travis Hamonic,49,3,11,14,0.0405,
8474612,20152016,Travis Hamonic,72,5,16,21,0.034,
8474612,20142015,Travis Hamonic,71,5,28,33,0.0379,
8474612,20132014,Travis Hamonic,69,3,15,18,0.0224,
8474612,20122013,Travis Hamonic,48,3,7,10,0.0361,
8474612,20112012,Travis Hamonic,73,2,22,24,0.0161,
8474612,20102011,Travis Hamonic,62,5,21,26,0.0424,
8475718,20242025,Justin Holl,73,2,6,8,0.04878,1.7
8475718,20232024,Justin Holl,38,0,5,5,0.0,0.61
8475718,20222023,Justin Holl,80,2,16,18,0.033333,3.9
8475718,20212022,Justin Holl,69,3,20,23,0.047,3.46
8475718,20202021,Justin Holl,55,2,18,20,0.035,2.5
8475718,20192020,Justin Holl,68,2,16,18,0.022,
8475718,20182019,Justin Holl,11,0,1,1,0.0,
8475718,20172018,Justin Holl,2,2,0,2,1.0,
8478021,20242025,William Lagesson,7,0,1,1,0.0,0.1
8478021,20232024,William Lagesson,10,0,0,0,0.0,0.87
8480070,20242025,Ian Mitchell,15,0,1,1,0.0,0.47
8480070,20232024,Ian Mitchell,13,0,2,2,0.0,0.52
8480070,20222023,Ian Mitchell,35,1,7,8,0.04,0.88
8480070,20212022,Ian Mitchell,8,0,1,1,0.0,0.08
8480070,20202021,Ian Mitchell,39,3,4,7,0.13,1.21
8477934,20242025,Leon Draisaitl,71,52,54,106,0.216667,31.42
8477934,20232024,Leon Draisaitl,81,41,65,106,0.18894,30.8
8477934,20222023,Leon Draisaitl,80,52,76,128,0.210526,35.67
8477934,20212022,Leon Draisaitl,80,55,55,110,0.198,42.54
8477934,20202021,Leon Draisaitl,56,31,53,84,0.185,24
8477934,20192020,Leon Draisaitl,71,43,67,110,0.197,
8477934,20182019,Leon Draisaitl,82,50,55,105,0.2165,
8477934,20172018,Leon Draisaitl,78,25,45,70,0.1289,
8477934,20162017,Leon Draisaitl,82,29,48,77,0.1686,
8477934,20152016,Leon Draisaitl,72,19,32,51,0.1429,
8477934,20142015,Leon Draisaitl,37,2,7,9,0.0408,
8479365,20242025,Trent Frederic,1,0,0,0,0.0,9.71
8479365,20232024,Trent Frederic,82,18,22,40,0.146341,16.58
8479365,20222023,Trent Frederic,79,17,14,31,0.141667,14.17
8479365,20212022,Trent Frederic,60,8,10,18,0.08,10.81
8479365,20202021,Trent Frederic,42,4,1,5,0.091,3.63
8479365,20192020,Trent Frederic,2,0,0,0,0.0,
8479365,20182019,Trent Frederic,15,0,0,0,0.0,
8474641,20242025,Adam Henrique,81,12,15,27,0.115385,12.78
8474641,20232024,Adam Henrique,22,6,3,9,0.206897,21.44
8474641,20222023,Adam Henrique,62,22,16,38,0.166667,18.69
8474641,20212022,Adam Henrique,58,19,23,42,0.135,19.56
8474641,20202021,Adam Henrique,45,12,9,21,0.156,7.82
8474641,20192020,Adam Henrique,71,26,17,43,0.154,
8474641,20182019,Adam Henrique,82,18,24,42,0.1475,
8474641,20172018,Adam Henrique,57,20,16,36,0.1961,
8474641,20162017,Adam Henrique,82,20,20,40,0.1408,
8474641,20152016,Adam Henrique,80,30,20,50,0.2013,
8474641,20142015,Adam Henrique,75,16,27,43,0.126,
8474641,20132014,Adam Henrique,77,25,18,43,0.1825,
8474641,20122013,Adam Henrique,42,11,5,16,0.141,
8474641,20112012,Adam Henrique,74,16,35,51,0.1231,
8474641,20102011,Adam Henrique,1,0,0,0,0.0,
8475786,20242025,Zach Hyman,73,27,17,44,0.128571,38.01
8475786,20232024,Zach Hyman,80,54,23,77,0.186207,52.51
8475786,20222023,Zach Hyman,79,36,47,83,0.130435,51.19
8475786,20212022,Zach Hyman,76,27,27,54,0.127,34.26
8475786,20202021,Zach Hyman,43,15,18,33,0.13,18.58
8475786,20192020,Zach Hyman,51,21,16,37,0.198,
8475786,20182019,Zach Hyman,71,21,20,41,0.1458,
8475786,20172018,Zach Hyman,82,15,25,40,0.1014,
8475786,20162017,Zach Hyman,82,10,18,28,0.0641,
8475786,20152016,Zach Hyman,16,4,2,6,0.1081,
8477406,20242025,Mattias Janmark,80,2,16,18,0.039216,8.89
8477406,20232024,Mattias Janmark,71,4,8,12,0.059701,9.18
8477406,20222023,Mattias Janmark,66,10,15,25,0.126582,10.33
8477406,20212022,Mattias Janmark,67,9,16,25,0.101,10.69
8477406,20202021,Mattias Janmark,15,1,4,5,0.043,11.07
8477406,20192020,Mattias Janmark,62,6,15,21,0.07,
8477406,20182019,Mattias Janmark,81,6,19,25,0.0571,
8477406,20172018,Mattias Janmark,81,19,15,34,0.1397,
8479368,20242025,Max Jones,19,1,1,2,0.066667,2.15
8479368,20232024,Max Jones,52,5,10,15,0.065789,9.89
8479368,20222023,Max Jones,69,9,10,19,0.084112,12.57
8479368,20212022,Max Jones,2,0,0,0,0.0,0.06
8479368,20202021,Max Jones,46,7,4,11,0.091,8.7
8479368,20192020,Max Jones,59,8,4,12,0.078,
8479368,20182019,Max Jones,30,2,3,5,0.0345,
8477953,20242025,Kasperi Kapanen,57,5,8,13,0.090909,5.73
8477953,20232024,Kasperi Kapanen,73,6,16,22,0.060606,10.02
8477953,20222023,Kasperi Kapanen,23,8,6,14,0.170213,9.62
8477953,20212022,Kasperi Kapanen,79,11,21,32,0.085,11.13
8477953,20202021,Kasperi Kapanen,40,11,19,30,0.162,5.01
8477953,20192020,Kasperi Kapanen,69,13,23,36,0.107,
8477953,20182019,Kasperi Kapanen,78,20,24,44,0.1149,
8477953,20172018,Kasperi Kapanen,38,7,2,9,0.1273,
8477953,20162017,Kasperi Kapanen,8,1,0,1,0.0909,
8477953,20152016,Kasperi Kapanen,9,0,0,0,0.0,
8477508,20242025,Curtis Lazar,48,2,3,5,0.074074,2.84
8477508,20232024,Curtis Lazar,71,7,18,25,0.094595,9.29
8477508,20222023,Curtis Lazar,4,0,0,0,0.0,6.63
8477508,20212022,Curtis Lazar,70,8,8,16,0.084,10.13
8477508,20202021,Curtis Lazar,17,2,2,4,0.1,8.58
8477508,20192020,Curtis Lazar,38,5,5,10,0.152,
8477508,20182019,Curtis Lazar,1,0,0,0,0.0,
8477508,20172018,Curtis Lazar,65,2,10,12,0.0308,
8477508,20162017,Curtis Lazar,4,1,2,3,0.5,
8477508,20152016,Curtis Lazar,76,6,14,20,0.0769,
8477508,20142015,Curtis Lazar,67,6,9,15,0.0652,
8478233,20242025,Andrew Mangiapane,81,14,14,28,0.147368,14.43
8478233,20232024,Andrew Mangiapane,75,14,26,40,0.114754,20.71
8478233,20222023,Andrew Mangiapane,82,17,26,43,0.093407,24.44
8478233,20212022,Andrew Mangiapane,82,35,20,55,0.189,26.63
8478233,20202021,Andrew Mangiapane,56,18,14,32,0.198,13.56
8478233,20192020,Andrew Mangiapane,68,17,15,32,0.156,
8478233,20182019,Andrew Mangiapane,44,8,5,13,0.1231,
8478233,20172018,Andrew Mangiapane,10,0,0,0,0.0,
8478402,20242025,Connor McDavid,67,26,74,100,0.132653,26.91
8478402,20232024,Connor McDavid,76,32,100,132,0.121673,30.56
8478402,20222023,Connor McDavid,82,64,89,153,0.181818,45.31
8478402,20212022,Connor McDavid,80,44,79,123,0.14,42.51
8478402,20202021,Connor McDavid,56,33,72,105,0.165,24.74
8478402,20192020,Connor McDavid,64,34,63,97,0.16,
8478402,20182019,Connor McDavid,78,41,75,116,0.1708,
8478402,20172018,Connor McDavid,82,41,67,108,0.1496,
8478402,20162017,Connor McDavid,82,30,70,100,0.1195,
8478402,20152016,Connor McDavid,45,16,32,48,0.1524,
8476454,20242025,Ryan Nugent-Hopkins,78,20,29,49,0.121951,25.09
8476454,20232024,Ryan Nugent-Hopkins,80,18,49,67,0.098361,24.4
8476454,20222023,Ryan Nugent-Hopkins,82,37,67,104,0.18408,31.19
8476454,20212022,Ryan Nugent-Hopkins,63,11,39,50,0.071,15.14
8476454,20202021,Ryan Nugent-Hopkins,52,16,19,35,0.119,17.16
8476454,20192020,Ryan Nugent-Hopkins,65,22,39,61,0.128,
8476454,20182019,Ryan Nugent-Hopkins,82,28,41,69,0.1346,
8476454,20172018,Ryan Nugent-Hopkins,62,24,24,48,0.1589,
8476454,20162017,Ryan Nugent-Hopkins,82,18,25,43,0.09,
8476454,20152016,Ryan Nugent-Hopkins,55,12,22,34,0.1111,
8476454,20142015,Ryan Nugent-Hopkins,76,24,32,56,0.127,
8476454,20132014,Ryan Nugent-Hopkins,80,19,37,56,0.1067,
8476454,20122013,Ryan Nugent-Hopkins,40,4,20,24,0.0513,
8476454,20112012,Ryan Nugent-Hopkins,62,18,34,52,0.1343,
8480803,20242025,Evan Bouchard,82,14,53,67,0.059574,13.04
8480803,20232024,Evan Bouchard,81,18,64,82,0.081818,12.12
8480803,20222023,Evan Bouchard,82,8,32,40,0.051282,7.86
8480803,20212022,Evan Bouchard,81,12,31,43,0.059,8.14
8480803,20202021,Evan Bouchard,14,2,3,5,0.053,1.69
8477384,20242025,Joshua Brown,10,0,1,1,0.0,0.26
8477384,20232024,Joshua Brown,51,3,7,10,0.068182,1.95
8477384,20222023,Joshua Brown,68,4,3,7,0.058824,3.69
8477384,20212022,Joshua Brown,6,0,0,0,0.0,1.13
8477384,20202021,Joshua Brown,26,0,1,1,0.0,0.28
8477384,20192020,Joshua Brown,56,3,5,8,0.063,
8477384,20182019,Joshua Brown,37,1,1,2,0.0357,
8475218,20242025,Mattias Ekholm,65,9,24,33,0.062937,7.78
8475218,20232024,Mattias Ekholm,79,11,34,45,0.062147,10.88
8475218,20222023,Mattias Ekholm,21,4,10,14,0.111111,8.04
8475218,20212022,Mattias Ekholm,76,6,25,31,0.041,9.22
8475218,20202021,Mattias Ekholm,48,6,17,23,0.055,5.47
8475218,20192020,Mattias Ekholm,68,8,25,33,0.052,
8475218,20182019,Mattias Ekholm,80,8,36,44,0.0548,
8475218,20172018,Mattias Ekholm,81,10,24,34,0.0741,
8475218,20162017,Mattias Ekholm,82,3,20,23,0.025,
8475218,20152016,Mattias Ekholm,82,8,27,35,0.0702,
8475218,20142015,Mattias Ekholm,80,7,11,18,0.0814,
8475218,20132014,Mattias Ekholm,62,1,8,9,0.0172,
8475218,20122013,Mattias Ekholm,1,0,0,0,0.0,
8475218,20112012,Mattias Ekholm,2,0,0,0,0.0,
8476967,20242025,Brett Kulak,82,7,18,25,0.051852,6.56
8476967,20232024,Brett Kulak,82,3,13,16,0.031915,3.5
8476967,20222023,Brett Kulak,82,3,17,20,0.026316,3.37
8476967,20212022,Brett Kulak,18,2,6,8,0.069,2.89
8476967,20202021,Brett Kulak,46,2,6,8,0.035,2.02
8476967,20192020,Brett Kulak,56,0,7,7,0.0,
8476967,20182019,Brett Kulak,57,6,11,17,0.0588,
8476967,20172018,Brett Kulak,71,2,6,8,0.0274,
8476967,20162017,Brett Kulak,21,0,3,3,0.0,
8476967,20152016,Brett Kulak,8,0,0,0,0.0,
8476967,20142015,Brett Kulak,1,0,0,0,0.0,
8477498,20242025,Darnell Nurse,76,5,28,33,0.026596,7.96
8477498,20232024,Darnell Nurse,81,10,22,32,0.055249,9.32
8477498,20222023,Darnell Nurse,82,12,31,43,0.059113,9.11
8477498,20212022,Darnell Nurse,71,9,26,35,0.044,10.71
8477498,20202021,Darnell Nurse,56,16,20,36,0.104,8.25
8477498,20192020,Darnell Nurse,71,5,28,33,0.029,
8477498,20182019,Darnell Nurse,82,10,31,41,0.051,
8477498,20172018,Darnell Nurse,82,6,20,26,0.0309,
8477498,20162017,Darnell Nurse,44,5,6,11,0.0588,
8477498,20152016,Darnell Nurse,69,3,7,10,0.025,
8477498,20142015,Darnell Nurse,2,0,0,0,0.0,
8479442,20242025,Troy Stecher,66,3,4,7,0.054545,1.96
8479442,20232024,Troy Stecher,7,0,2,2,0.0,3.68
8479442,20222023,Troy Stecher,20,3,4,7,0.115385,3.77
8479442,20212022,Troy Stecher,13,0,1,1,0.0,1.5
8479442,20202021,Troy Stecher,44,3,8,11,0.055,1.93
8479442,20192020,Troy Stecher,69,5,12,17,0.058,
8479442,20182019,Troy Stecher,78,2,21,23,0.019,
8479442,20172018,Troy Stecher,68,1,10,11,0.0106,
8479442,20162017,Troy Stecher,71,3,21,24,0.024,
8479388,20242025,Riley Stillman,5,0,0,0,0.0,0.08
8478013,20242025,Jake Walman,15,1,7,8,0.025641,9.76
8478013,20232024,Jake Walman,63,12,9,21,0.111111,4.59
8478013,20222023,Jake Walman,63,9,9,18,0.064286,6.49
8478013,20212022,Jake Walman,19,0,4,4,0.0,4.92
8478013,20202021,Jake Walman,24,1,1,2,0.021,1.8
8478013,20192020,Jake Walman,1,0,0,0,0.0,
8477493,20242025,Aleksander Barkov,67,20,51,71,0.134228,21.84
8477493,20232024,Aleksander Barkov,73,23,57,80,0.119171,27.93
8477493,20222023,Aleksander Barkov,68,23,55,78,0.110577,21.91
8477493,20212022,Aleksander Barkov,67,39,49,88,0.182,28.66
8477493,20202021,Aleksander Barkov,50,26,32,58,0.148,20.69
8477493,20192020,Aleksander Barkov,66,20,42,62,0.116,
8477493,20182019,Aleksander Barkov,82,35,61,96,0.1699,
8477493,20172018,Aleksander Barkov,79,27,51,78,0.1055,
8477493,20162017,Aleksander Barkov,61,21,31,52,0.1479,
8477493,20152016,Aleksander Barkov,66,28,31,59,0.1637,
8477493,20142015,Aleksander Barkov,71,16,20,36,0.1301,
8477493,20132014,Aleksander Barkov,54,8,16,24,0.092,
8477935,20242025,Sam Bennett,76,25,26,51,0.103734,32.86
8477935,20232024,Sam Bennett,69,20,21,41,0.116959,25.01
8477935,20222023,Sam Bennett,63,16,24,40,0.082902,22.92
8477935,20212022,Sam Bennett,71,28,21,49,0.116,27.06
8477935,20202021,Sam Bennett,10,6,9,15,0.154,12.12
8477935,20192020,Sam Bennett,52,8,4,12,0.098,
8477935,20182019,Sam Bennett,71,13,14,27,0.113,
8477935,20172018,Sam Bennett,82,11,15,26,0.0701,
8477935,20162017,Sam Bennett,81,13,13,26,0.1066,
8477935,20152016,Sam Bennett,77,18,18,36,0.1324,
8477935,20142015,Sam Bennett,1,0,1,1,0.0,
8480003,20242025,Jesper Boqvist,78,12,11,23,0.137931,10.54
8480003,20232024,Jesper Boqvist,47,6,8,14,0.117647,4.35
8480003,20222023,Jesper Boqvist,70,10,11,21,0.149254,8.8
8480003,20212022,Jesper Boqvist,56,10,13,23,0.135,7.84
8480003,20202021,Jesper Boqvist,28,4,3,7,0.118,3.86
8480003,20192020,Jesper Boqvist,35,4,0,4,0.098,
8481518,20242025,Nolan Foote,7,0,1,1,0.0,0.51
8481518,20232024,Nolan Foote,4,1,0,1,0.166667,0.75
8481518,20222023,Nolan Foote,6,1,0,1,0.25,0.55
8481518,20212022,Nolan Foote,7,3,1,4,0.3,1.51
8481518,20202021,Nolan Foote,6,1,1,2,0.2,0.29
8479981,20242025,Jonah Gadjovich,42,4,0,4,0.093023,5.27
8479981,20232024,Jonah Gadjovich,39,2,2,4,0.068966,3.3
8479981,20222023,Jonah Gadjovich,35,3,4,7,0.09375,5.7
8479981,20212022,Jonah Gadjovich,43,1,2,3,0.028,5.02
8479981,20202021,Jonah Gadjovich,1,0,0,0,0.0,0
8478421,20242025,A.J. Greer,81,6,11,17,0.069767,11.18
8478421,20232024,A.J. Greer,59,6,6,12,0.105263,6.58
8478421,20222023,A.J. Greer,61,5,7,12,0.075758,8.74
8478421,20212022,A.J. Greer,9,1,1,2,0.071,1.38
8478421,20202021,A.J. Greer,1,0,0,0,0.0,0
8479316,20242025,Luke Kunin,12,0,0,0,0.0,16.64
8479316,20232024,Luke Kunin,77,11,7,18,0.112245,13.12
8479316,20222023,Luke Kunin,31,5,8,13,0.086207,7.33
8479316,20212022,Luke Kunin,82,13,9,22,0.104,15.32
8479316,20202021,Luke Kunin,38,10,9,19,0.141,7.73
8479316,20192020,Luke Kunin,63,15,16,31,0.117,
8479316,20182019,Luke Kunin,49,6,11,17,0.0682,
8479316,20172018,Luke Kunin,19,2,2,4,0.0625,
8480185,20242025,Eetu Luostarinen,80,9,15,24,0.103448,13.82
8480185,20232024,Eetu Luostarinen,82,12,15,27,0.10084,18.14
8480185,20222023,Eetu Luostarinen,82,17,26,43,0.128788,17.79
8480185,20212022,Eetu Luostarinen,78,9,17,26,0.107,10.25
8480185,20202021,Eetu Luostarinen,44,3,5,8,0.088,4.15
8480185,20192020,Eetu Luostarinen,8,0,1,1,0.0,
8473419,20242025,Brad Marchand,10,2,2,4,0.105263,29.24
8473419,20232024,Brad Marchand,82,29,38,67,0.140097,26.84
8473419,20222023,Brad Marchand,73,21,46,67,0.114754,22.73
8473419,20212022,Brad Marchand,70,32,48,80,0.132,26.52
8473419,20202021,Brad Marchand,53,29,40,69,0.203,18.65
8473419,20192020,Brad Marchand,70,28,59,87,0.151,
8473419,20182019,Brad Marchand,79,36,64,100,0.1558,
8473419,20172018,Brad Marchand,68,34,51,85,0.1868,
8473419,20162017,Brad Marchand,80,39,46,85,0.1726,
8473419,20152016,Brad Marchand,77,37,24,61,0.148,
8473419,20142015,Brad Marchand,77,24,18,42,0.1333,
8473419,20132014,Brad Marchand,82,25,28,53,0.1678,
8473419,20122013,Brad Marchand,45,18,18,36,0.1978,
8473419,20112012,Brad Marchand,76,28,27,55,0.1677,
8473419,20102011,Brad Marchand,77,21,20,41,0.1409,
8473419,20092010,Brad Marchand,20,0,1,1,0.0,
8477931,20242025,Tomas Nosek,59,1,8,9,0.021277,7.55
8477931,20232024,Tomas Nosek,36,2,4,6,0.052632,3.34
8477931,20222023,Tomas Nosek,66,7,11,18,0.101449,8.65
8477931,20212022,Tomas Nosek,75,3,14,17,0.036,10.24
8477931,20202021,Tomas Nosek,38,8,10,18,0.136,7.39
8477931,20192020,Tomas Nosek,67,8,7,15,0.086,
8477931,20182019,Tomas Nosek,68,8,9,17,0.069,
8477931,20172018,Tomas Nosek,67,7,8,15,0.0761,
8477931,20162017,Tomas Nosek,11,1,0,1,0.0526,
8477931,20152016,Tomas Nosek,6,0,0,0,0.0,
8477933,20242025,Sam Reinhart,79,39,42,81,0.183099,36.77
8477933,20232024,Sam Reinhart,82,57,37,94,0.244635,44.25
8477933,20222023,Sam Reinhart,82,31,36,67,0.136564,37.24
8477933,20212022,Sam Reinhart,78,33,49,82,0.177,30.51
8477933,20202021,Sam Reinhart,54,25,15,40,0.192,18.56
8477933,20192020,Sam Reinhart,69,22,28,50,0.153,
8477933,20182019,Sam Reinhart,82,22,43,65,0.1222,
8477933,20172018,Sam Reinhart,82,25,25,50,0.133,
8477933,20162017,Sam Reinhart,79,17,30,47,0.0955,
8477933,20152016,Sam Reinhart,79,23,19,42,0.1394,
8477933,20142015,Sam Reinhart,9,0,1,1,0.0,
8478542,20242025,Evan Rodrigues,82,15,17,32,0.093168,17.13
8478542,20232024,Evan Rodrigues,80,12,27,39,0.064516,18.07
8478542,20222023,Evan Rodrigues,69,16,23,39,0.086957,21.34
8478542,20212022,Evan Rodrigues,82,19,24,43,0.078,22.84
8478542,20202021,Evan Rodrigues,35,7,7,14,0.108,6.14
8478542,20192020,Evan Rodrigues,7,1,0,1,0.091,
8478542,20182019,Evan Rodrigues,74,9,20,29,0.0536,
8478542,20172018,Evan Rodrigues,48,7,18,25,0.0769,
8478542,20162017,Evan Rodrigues,30,4,2,6,0.0784,
8478542,20152016,Evan Rodrigues,2,1,1,2,0.125,
8479314,20242025,Matthew Tkachuk,52,22,35,57,0.141026,24.29
8479314,20232024,Matthew Tkachuk,80,26,62,88,0.092857,38.86
8479314,20222023,Matthew Tkachuk,79,40,69,109,0.124224,45.48
8479314,20212022,Matthew Tkachuk,82,42,62,104,0.166,34.58
8479314,20202021,Matthew Tkachuk,56,16,27,43,0.106,19.11
8479314,20192020,Matthew Tkachuk,69,23,38,61,0.122,
8479314,20182019,Matthew Tkachuk,80,34,43,77,0.1643,
8479314,20172018,Matthew Tkachuk,68,24,25,49,0.1277,
8479314,20162017,Matthew Tkachuk,76,13,35,48,0.0915,
8477409,20242025,Carter Verhaeghe,81,20,33,53,0.082645,28.59
8477409,20232024,Carter Verhaeghe,76,34,38,72,0.138211,31.15
8477409,20222023,Carter Verhaeghe,81,42,31,73,0.152727,33.86
8477409,20212022,Carter Verhaeghe,78,24,31,55,0.144,21.11
8477409,20202021,Carter Verhaeghe,43,18,18,36,0.168,14.71
8477409,20192020,Carter Verhaeghe,52,9,4,13,0.158,
8481600,20242025,Tobias Bjornfot,14,0,0,0,0.0,0.74
8481600,20232024,Tobias Bjornfot,1,0,0,0,0.0,0.01
8481600,20222023,Tobias Bjornfot,10,0,1,1,0.0,0.27
8481600,20212022,Tobias Bjornfot,70,0,8,8,0.0,2.58
8481600,20202021,Tobias Bjornfot,33,1,5,6,0.033,0.98
8481600,20192020,Tobias Bjornfot,3,0,0,0,0.0,
8477932,20242025,Aaron Ekblad,56,3,30,33,0.028302,5.95
8477932,20232024,Aaron Ekblad,51,4,14,18,0.040816,8.22
8477932,20222023,Aaron Ekblad,71,14,24,38,0.064815,16.17
8477932,20212022,Aaron Ekblad,61,15,42,57,0.083,10.72
8477932,20202021,Aaron Ekblad,35,11,11,22,0.109,6.28
8477932,20192020,Aaron Ekblad,67,5,36,41,0.034,
8477932,20182019,Aaron Ekblad,82,13,24,37,0.0722,
8477932,20172018,Aaron Ekblad,82,16,22,38,0.0847,
8477932,20162017,Aaron Ekblad,68,10,11,21,0.0444,
8477932,20152016,Aaron Ekblad,78,15,21,36,0.0824,
8477932,20142015,Aaron Ekblad,81,12,27,39,0.0706,
8478055,20242025,Gustav Forsling,80,11,20,31,0.05641,7.49
8478055,20232024,Gustav Forsling,79,10,29,39,0.0625,7.45
8478055,20222023,Gustav Forsling,82,13,28,41,0.062201,8.39
8478055,20212022,Gustav Forsling,71,10,27,37,0.069,7.9
8478055,20202021,Gustav Forsling,43,5,12,17,0.053,3.62
8477495,20242025,Seth Jones,21,2,7,9,0.041667,8.29
8477495,20232024,Seth Jones,67,8,23,31,0.046512,9.2
8477495,20222023,Seth Jones,72,12,25,37,0.067416,8.88
8477495,20212022,Seth Jones,78,5,46,51,0.026,7.08
8477495,20202021,Seth Jones,56,5,23,28,0.035,6.19
8477495,20192020,Seth Jones,56,6,24,30,0.048,
8477495,20182019,Seth Jones,75,9,37,46,0.0489,
8477495,20172018,Seth Jones,78,16,41,57,0.0643,
8477495,20162017,Seth Jones,75,12,30,42,0.0789,
8477495,20152016,Seth Jones,41,2,18,20,0.0241,
8477495,20142015,Seth Jones,82,8,19,27,0.065,
8477495,20132014,Seth Jones,77,6,19,25,0.06,
8475179,20242025,Dmitry Kulikov,70,4,9,13,0.0625,3.04
8475179,20232024,Dmitry Kulikov,76,1,19,20,0.013514,4.67
8475179,20222023,Dmitry Kulikov,6,0,1,1,0.0,3.74
8475179,20212022,Dmitry Kulikov,80,7,17,24,0.095,5.01
8475179,20202021,Dmitry Kulikov,10,0,2,2,0.0,1.69
8475179,20192020,Dmitry Kulikov,51,2,8,10,0.037,
8475179,20182019,Dmitry Kulikov,57,0,6,6,0.0,
8475179,20172018,Dmitry Kulikov,62,3,8,11,0.0625,
8475179,20162017,Dmitry Kulikov,47,2,3,5,0.0476,
8475179,20152016,Dmitry Kulikov,74,1,16,17,0.0101,
8475179,20142015,Dmitry Kulikov,73,3,19,22,0.0361,
8475179,20132014,Dmitry Kulikov,81,8,11,19,0.063,
8475179,20122013,Dmitry Kulikov,34,3,7,10,0.0577,
8475179,20112012,Dmitry Kulikov,58,4,24,28,0.0385,
8475179,20102011,Dmitry Kulikov,72,6,20,26,0.0723,
8475179,20092010,Dmitry Kulikov,68,3,13,16,0.0345,
8478859,20242025,Niko Mikkola,76,6,16,22,0.051724,5.74
8478859,20232024,Niko Mikkola,82,3,14,17,0.032258,4.31
8478859,20222023,Niko Mikkola,31,1,2,3,0.032258,2.34
8478859,20212022,Niko Mikkola,54,3,10,13,0.052,2.43
8478859,20202021,Niko Mikkola,30,1,2,3,0.045,0.7
8478859,20192020,Niko Mikkola,5,0,1,1,0.0,
8473507,20242025,Jeff Petry,44,1,7,8,0.030303,1.72
8473507,20232024,Jeff Petry,73,3,21,24,0.035714,3.73
8473507,20222023,Jeff Petry,61,5,26,31,0.044248,4.27
8473507,20212022,Jeff Petry,68,6,21,27,0.048,4.57
8473507,20202021,Jeff Petry,55,12,30,42,0.094,7.25
8473507,20192020,Jeff Petry,71,11,29,40,0.07,
8473507,20182019,Jeff Petry,82,13,33,46,0.0756,
8473507,20172018,Jeff Petry,82,12,30,42,0.0674,
8473507,20162017,Jeff Petry,80,8,20,28,0.0465,
8473507,20152016,Jeff Petry,51,5,11,16,0.051,
8473507,20142015,Jeff Petry,19,3,4,7,0.1304,
8473507,20132014,Jeff Petry,80,7,10,17,0.0729,
8473507,20122013,Jeff Petry,48,3,9,12,0.0455,
8473507,20112012,Jeff Petry,73,2,23,25,0.018,
8473507,20102011,Jeff Petry,35,1,4,5,0.0244,
8476469,20242025,Joel Armia,81,11,18,29,0.105769,13.42
8476469,20232024,Joel Armia,66,17,8,25,0.122302,12.37
8476469,20222023,Joel Armia,43,7,7,14,0.101449,8.84
8476469,20212022,Joel Armia,60,6,8,14,0.058,10.13
8476469,20202021,Joel Armia,41,7,7,14,0.096,6.33
8476469,20192020,Joel Armia,58,16,14,30,0.103,
8476469,20182019,Joel Armia,57,13,10,23,0.097,
8476469,20172018,Joel Armia,79,12,17,29,0.0938,
8476469,20162017,Joel Armia,57,10,9,19,0.0901,
8476469,20152016,Joel Armia,43,4,6,10,0.0769,
8476469,20142015,Joel Armia,1,0,0,0,0.0,
8482124,20242025,Quinton Byfield,81,23,31,54,0.146497,22.09
8482124,20232024,Quinton Byfield,80,20,35,55,0.124224,26.93
8482124,20222023,Quinton Byfield,53,3,19,22,0.040541,10.55
8482124,20212022,Quinton Byfield,40,5,5,10,0.128,5.56
8482124,20202021,Quinton Byfield,6,0,1,1,0.0,0.64
8476479,20242025,Phillip Danault,80,8,35,43,0.065041,15.06
8476479,20232024,Phillip Danault,78,17,30,47,0.106918,19.08
8476479,20222023,Phillip Danault,82,18,36,54,0.118421,17.83
8476479,20212022,Phillip Danault,79,27,24,51,0.139,25.97
8476479,20202021,Phillip Danault,53,5,19,24,0.068,7.97
8476479,20192020,Phillip Danault,71,13,34,47,0.099,
8476479,20182019,Phillip Danault,81,12,41,53,0.0909,
8476479,20172018,Phillip Danault,52,8,17,25,0.0851,
8476479,20162017,Phillip Danault,82,13,27,40,0.0977,
8476479,20152016,Phillip Danault,21,3,2,5,0.125,
8476479,20142015,Phillip Danault,2,0,0,0,0.0,
8477942,20242025,Kevin Fiala,81,35,25,60,0.143443,28.48
8477942,20232024,Kevin Fiala,82,29,44,73,0.128889,25.37
8477942,20222023,Kevin Fiala,69,23,49,72,0.110577,26.01
8477942,20212022,Kevin Fiala,82,33,52,85,0.126,28.33
8477942,20202021,Kevin Fiala,50,20,20,40,0.123,16.43
8477942,20192020,Kevin Fiala,64,23,31,54,0.131,
8477942,20182019,Kevin Fiala,19,3,4,7,0.0698,
8477942,20172018,Kevin Fiala,80,23,25,48,0.123,
8477942,20162017,Kevin Fiala,54,11,5,16,0.0965,
8477942,20152016,Kevin Fiala,5,1,0,1,0.0909,
8477942,20142015,Kevin Fiala,1,0,0,0,0.0,
8477998,20242025,Warren Foegele,82,24,22,46,0.120603,26.1
8477998,20232024,Warren Foegele,82,20,21,41,0.099502,26.19
8477998,20222023,Warren Foegele,67,13,15,28,0.103175,18.11
8477998,20212022,Warren Foegele,82,12,14,26,0.085,17.37
8477998,20202021,Warren Foegele,53,10,10,20,0.11,13.56
8477998,20192020,Warren Foegele,68,13,17,30,0.101,
8477998,20182019,Warren Foegele,77,10,5,15,0.0943,
8477998,20172018,Warren Foegele,2,2,1,3,0.3333,
8477960,20242025,Adrian Kempe,81,35,38,73,0.147679,29.58
8477960,20232024,Adrian Kempe,77,28,47,75,0.113821,24.75
8477960,20222023,Adrian Kempe,82,41,26,67,0.164,28.73
8477960,20212022,Adrian Kempe,78,35,19,54,0.142,30.25
8477960,20202021,Adrian Kempe,56,14,15,29,0.11,11.1
8477960,20192020,Adrian Kempe,69,11,21,32,0.074,
8477960,20182019,Adrian Kempe,81,12,16,28,0.1017,
8477960,20172018,Adrian Kempe,81,16,21,37,0.1345,
8477960,20162017,Adrian Kempe,25,2,4,6,0.0625,
8471685,20242025,Anze Kopitar,81,21,46,67,0.214286,15.44
8471685,20232024,Anze Kopitar,81,26,44,70,0.195489,18.21
8471685,20222023,Anze Kopitar,82,28,46,74,0.16568,23.9
8471685,20212022,Anze Kopitar,81,19,48,67,0.09,20.76
8471685,20202021,Anze Kopitar,56,13,37,50,0.11,11.07
8471685,20192020,Anze Kopitar,70,21,41,62,0.156,
8471685,20182019,Anze Kopitar,81,22,38,60,0.141,
8471685,20172018,Anze Kopitar,82,35,57,92,0.175,
8471685,20162017,Anze Kopitar,76,12,40,52,0.08,
8471685,20152016,Anze Kopitar,81,25,49,74,0.1412,
8471685,20142015,Anze Kopitar,79,16,48,64,0.1194,
8471685,20132014,Anze Kopitar,82,29,41,70,0.145,
8471685,20122013,Anze Kopitar,47,10,32,42,0.102,
8471685,20112012,Anze Kopitar,82,25,51,76,0.1087,
8471685,20102011,Anze Kopitar,75,25,48,73,0.1073,
8471685,20092010,Anze Kopitar,82,34,47,81,0.1313,
8471685,20082009,Anze Kopitar,82,27,39,66,0.1154,
8471685,20072008,Anze Kopitar,82,32,45,77,0.1592,
8471685,20062007,Anze Kopitar,72,20,41,61,0.1036,
8479675,20242025,Trevor Moore,71,18,22,40,0.117647,19.42
8479675,20232024,Trevor Moore,82,31,26,57,0.127049,28.41
8479675,20222023,Trevor Moore,59,10,19,29,0.06135,16.19
8479675,20212022,Trevor Moore,81,17,31,48,0.084,25.12
8479675,20202021,Trevor Moore,56,10,13,23,0.114,10.23
8479675,20192020,Trevor Moore,15,3,2,5,0.158,
8479675,20182019,Trevor Moore,25,2,6,8,0.0769,
8470621,20242025,Corey Perry,81,19,11,30,0.19,17.14
8470621,20232024,Corey Perry,38,8,5,13,0.142857,13.09
8470621,20222023,Corey Perry,81,12,13,25,0.103448,16.86
8470621,20212022,Corey Perry,82,19,21,40,0.124,25.11
8470621,20202021,Corey Perry,49,9,12,21,0.145,7.87
8470621,20192020,Corey Perry,57,5,16,21,0.065,
8470621,20182019,Corey Perry,31,6,4,10,0.1017,
8470621,20172018,Corey Perry,71,17,32,49,0.1012,
8470621,20162017,Corey Perry,82,19,34,53,0.0884,
8470621,20152016,Corey Perry,82,34,28,62,0.1581,
8470621,20142015,Corey Perry,67,33,22,55,0.171,
8470621,20132014,Corey Perry,81,43,39,82,0.1536,
8470621,20122013,Corey Perry,44,15,21,36,0.1172,
8470621,20112012,Corey Perry,80,37,23,60,0.1336,
8470621,20102011,Corey Perry,82,50,48,98,0.1724,
8470621,20092010,Corey Perry,82,27,49,76,0.1,
8470621,20082009,Corey Perry,78,32,40,72,0.1131,
8470621,20072008,Corey Perry,70,29,25,54,0.145,
8470621,20062007,Corey Perry,82,17,27,44,0.0876,
8470621,20052006,Corey Perry,56,13,12,25,0.1327,
8479998,20242025,Mikey Anderson,77,6,18,24,0.071429,5.65
8479998,20232024,Mikey Anderson,74,2,16,18,0.022472,4.5
8479998,20222023,Mikey Anderson,77,5,15,20,0.055556,4.64
8479998,20212022,Mikey Anderson,57,2,6,8,0.034,3.09
8479998,20202021,Mikey Anderson,54,1,10,11,0.019,1.53
8479998,20192020,Mikey Anderson,6,1,0,1,0.111,
8477335,20242025,Kyle Burroughs,33,0,3,3,0.0,0.18
8477335,20232024,Kyle Burroughs,73,2,6,8,0.025316,3.38
8477335,20222023,Kyle Burroughs,48,2,3,5,0.042553,1.71
8477335,20212022,Kyle Burroughs,42,1,4,5,0.026,1.62
8477335,20202021,Kyle Burroughs,5,0,1,1,0.0,0.1
8476879,20242025,Cody Ceci,31,0,9,9,0.0,3.5
8476879,20232024,Cody Ceci,79,5,20,25,0.051546,4.43
8476879,20222023,Cody Ceci,80,1,14,15,0.011364,4.21
8476879,20212022,Cody Ceci,78,5,23,28,0.049,3.3
8476879,20202021,Cody Ceci,53,4,13,17,0.069,2.43
8476879,20192020,Cody Ceci,56,1,7,8,0.021,
8476879,20182019,Cody Ceci,74,7,19,26,0.053,
8476879,20172018,Cody Ceci,82,5,14,19,0.035,
8476879,20162017,Cody Ceci,79,2,15,17,0.014,
8476879,20152016,Cody Ceci,75,10,16,26,0.0862,
8476879,20142015,Cody Ceci,81,5,16,21,0.0385,
8476879,20132014,Cody Ceci,49,3,6,9,0.0366,
8474563,20242025,Drew Doughty,30,4,13,17,0.086957,2.76
8474563,20232024,Drew Doughty,82,15,35,50,0.111111,8.5
8474563,20222023,Drew Doughty,81,9,43,52,0.062069,7.67
8474563,20212022,Drew Doughty,39,7,24,31,0.071,5.94
8474563,20202021,Drew Doughty,56,8,26,34,0.079,5.48
8474563,20192020,Drew Doughty,67,7,28,35,0.05,
8474563,20182019,Drew Doughty,82,8,37,45,0.0519,
8474563,20172018,Drew Doughty,82,10,50,60,0.0488,
8474563,20162017,Drew Doughty,82,12,32,44,0.0663,
8474563,20152016,Drew Doughty,82,14,37,51,0.0711,
8474563,20142015,Drew Doughty,82,7,39,46,0.032,
8474563,20132014,Drew Doughty,78,10,27,37,0.0565,
8474563,20122013,Drew Doughty,48,6,16,22,0.0526,
8474563,20112012,Drew Doughty,77,10,26,36,0.0595,
8474563,20102011,Drew Doughty,76,11,29,40,0.0791,
8474563,20092010,Drew Doughty,82,16,43,59,0.1127,
8474563,20082009,Drew Doughty,81,6,21,27,0.0476,
8475208,20242025,Brian Dumoulin,19,1,5,6,0.083333,3.91
8475208,20232024,Brian Dumoulin,80,6,10,16,0.086957,2.9
8475208,20222023,Brian Dumoulin,82,1,24,25,0.012195,4.06
8475208,20212022,Brian Dumoulin,76,3,15,18,0.033,3.9
8475208,20202021,Brian Dumoulin,41,4,10,14,0.08,2.08
8475208,20192020,Brian Dumoulin,28,1,7,8,0.029,
8475208,20182019,Brian Dumoulin,76,3,20,23,0.0303,
8475208,20172018,Brian Dumoulin,80,5,13,18,0.049,
8475208,20162017,Brian Dumoulin,70,1,14,15,0.0128,
8475208,20152016,Brian Dumoulin,79,0,16,16,0.0,
8475208,20142015,Brian Dumoulin,8,1,0,1,0.25,
8475208,20132014,Brian Dumoulin,6,0,1,1,0.0,
8476441,20242025,Joel Edmundson,73,6,14,20,0.065934,4.07
8476441,20232024,Joel Edmundson,9,0,0,0,0.0,2.49
8476441,20222023,Joel Edmundson,61,2,11,13,0.028986,2.78
8476441,20212022,Joel Edmundson,24,3,3,6,0.094,1.18
8476441,20202021,Joel Edmundson,55,3,10,13,0.039,4.06
8476441,20192020,Joel Edmundson,68,7,13,20,0.072,
8476441,20182019,Joel Edmundson,64,2,9,11,0.0196,
8476441,20172018,Joel Edmundson,69,7,10,17,0.0565,
8476441,20162017,Joel Edmundson,69,3,12,15,0.037,
8476441,20152016,Joel Edmundson,67,1,8,9,0.0111,
8477979,20242025,Nicolas Aube-Kubel,3,0,0,0,0.0,2.54
8477979,20232024,Nicolas Aube-Kubel,60,6,10,16,0.103448,5.67
8477979,20222023,Nicolas Aube-Kubel,47,4,8,12,0.061538,7.57
8477979,20212022,Nicolas Aube-Kubel,67,11,11,22,0.141,9.12
8477979,20202021,Nicolas Aube-Kubel,50,3,9,12,0.057,5.49
8477979,20192020,Nicolas Aube-Kubel,36,7,8,15,0.146,
8477979,20182019,Nicolas Aube-Kubel,9,0,0,0,0.0,
8478493,20242025,Joel Eriksson Ek,46,14,15,29,0.1,17.86
8478493,20232024,Joel Eriksson Ek,77,30,34,64,0.11236,39.29
8478493,20222023,Joel Eriksson Ek,78,23,38,61,0.093117,32.78
8478493,20212022,Joel Eriksson Ek,77,26,23,49,0.117,27.48
8478493,20202021,Joel Eriksson Ek,56,19,11,30,0.16,16.62
8478493,20192020,Joel Eriksson Ek,62,8,21,29,0.078,
8478493,20182019,Joel Eriksson Ek,58,7,7,14,0.0631,
8478493,20172018,Joel Eriksson Ek,75,6,10,16,0.0484,
8478493,20162017,Joel Eriksson Ek,15,3,4,7,0.2,
8475220,20242025,Marcus Foligno,77,14,15,29,0.153846,17.86
8475220,20232024,Marcus Foligno,55,10,12,22,0.178571,8.83
8475220,20222023,Marcus Foligno,65,7,14,21,0.084337,9.54
8475220,20212022,Marcus Foligno,74,23,19,42,0.235,17.67
8475220,20202021,Marcus Foligno,39,11,15,26,0.275,5.4
8475220,20192020,Marcus Foligno,59,11,14,25,0.128,
8475220,20182019,Marcus Foligno,82,7,12,19,0.0769,
8475220,20172018,Marcus Foligno,77,8,15,23,0.1013,
8475220,20162017,Marcus Foligno,80,13,10,23,0.134,
8475220,20152016,Marcus Foligno,75,10,13,23,0.1235,
8475220,20142015,Marcus Foligno,57,8,12,20,0.1212,
8475220,20132014,Marcus Foligno,74,7,12,19,0.0886,
8475220,20122013,Marcus Foligno,47,5,13,18,0.0909,
8475220,20112012,Marcus Foligno,14,6,7,13,0.2609,
8477451,20242025,Ryan Hartman,69,11,15,26,0.06962,18.28
8477451,20232024,Ryan Hartman,74,21,24,45,0.121387,22.96
8477451,20222023,Ryan Hartman,59,15,22,37,0.100671,15.92
8477451,20212022,Ryan Hartman,82,34,31,65,0.142,26.13
8477451,20202021,Ryan Hartman,51,7,15,22,0.095,8.1
8477451,20192020,Ryan Hartman,69,9,11,20,0.079,
8477451,20182019,Ryan Hartman,19,2,4,6,0.0625,
8477451,20172018,Ryan Hartman,21,3,3,6,0.0909,
8477451,20162017,Ryan Hartman,76,19,12,31,0.1118,
8477451,20152016,Ryan Hartman,3,0,1,1,0.0,
8477451,20142015,Ryan Hartman,5,0,0,0,0.0,
8476994,20242025,Vinnie Hinostroza,25,5,3,8,0.135135,8.92
8476994,20232024,Vinnie Hinostroza,14,1,2,3,0.037037,1.54
8476994,20222023,Vinnie Hinostroza,26,2,9,11,0.052632,2.77
8476994,20212022,Vinnie Hinostroza,62,13,12,25,0.141,8.25
8476994,20202021,Vinnie Hinostroza,17,4,8,12,0.148,2.52
8476994,20192020,Vinnie Hinostroza,68,5,17,22,0.038,
8476994,20182019,Vinnie Hinostroza,72,16,23,39,0.1053,
8476994,20172018,Vinnie Hinostroza,50,7,18,25,0.0814,
8476994,20162017,Vinnie Hinostroza,49,6,8,14,0.0789,
8476994,20152016,Vinnie Hinostroza,7,0,0,0,0.0,
8475149,20242025,Marcus Johansson,72,11,23,34,0.090909,12.42
8475149,20232024,Marcus Johansson,78,11,19,30,0.098214,13.04
8475149,20222023,Marcus Johansson,20,6,12,18,0.142857,14.7
8475149,20212022,Marcus Johansson,18,3,3,6,0.1,12.87
8475149,20202021,Marcus Johansson,36,6,8,14,0.13,4.93
8475149,20192020,Marcus Johansson,60,9,21,30,0.103,
8475149,20182019,Marcus Johansson,10,1,2,3,0.0833,
8475149,20172018,Marcus Johansson,29,5,9,14,0.119,
8475149,20162017,Marcus Johansson,82,24,34,58,0.186,
8475149,20152016,Marcus Johansson,74,17,29,46,0.1288,
8475149,20142015,Marcus Johansson,82,20,27,47,0.1449,
8475149,20132014,Marcus Johansson,80,8,36,44,0.0748,
8475149,20122013,Marcus Johansson,34,6,16,22,0.15,
8475149,20112012,Marcus Johansson,80,14,32,46,0.1556,
8475149,20102011,Marcus Johansson,69,13,14,27,0.1275,
8478864,20242025,Kirill Kaprizov,41,25,31,56,0.172414,20.38
8478864,20232024,Kirill Kaprizov,75,46,50,96,0.166065,38.57
8478864,20222023,Kirill Kaprizov,67,40,35,75,0.153257,35.23
8478864,20212022,Kirill Kaprizov,81,47,61,108,0.163,31.19
8478864,20202021,Kirill Kaprizov,55,27,24,51,0.172,20.46
8481477,20242025,Nico Sturm,15,0,1,1,0.0,6.83
8481477,20232024,Nico Sturm,63,5,8,13,0.072464,9.23
8481477,20222023,Nico Sturm,74,14,12,26,0.117647,13.16
8481477,20212022,Nico Sturm,21,0,3,3,0.0,10.87
8481477,20202021,Nico Sturm,50,11,6,17,0.172,8.4
8481477,20192020,Nico Sturm,6,0,2,2,0.0,
8481477,20182019,Nico Sturm,2,0,0,0,0.0,
8475765,20242025,Vladimir Tarasenko,80,11,22,33,0.082707,15.46
8475765,20232024,Vladimir Tarasenko,19,6,8,14,0.153846,15.62
8475765,20222023,Vladimir Tarasenko,31,8,13,21,0.121212,17.93
8475765,20212022,Vladimir Tarasenko,75,34,48,82,0.148,25.26
8475765,20202021,Vladimir Tarasenko,24,4,10,14,0.062,4.96
8475765,20192020,Vladimir Tarasenko,10,3,7,10,0.115,
8475765,20182019,Vladimir Tarasenko,76,33,35,68,0.12,
8475765,20172018,Vladimir Tarasenko,80,33,33,66,0.1078,
8475765,20162017,Vladimir Tarasenko,82,39,36,75,0.1364,
8475765,20152016,Vladimir Tarasenko,80,40,34,74,0.137,
8475765,20142015,Vladimir Tarasenko,77,37,36,73,0.1402,
8475765,20132014,Vladimir Tarasenko,64,21,22,43,0.1544,
8475765,20122013,Vladimir Tarasenko,38,8,11,19,0.1067,
8478508,20242025,Yakov Trenin,76,7,8,15,0.082353,11.56
8478508,20232024,Yakov Trenin,16,2,1,3,0.090909,15.64
8478508,20222023,Yakov Trenin,77,12,12,24,0.085714,17.56
8478508,20212022,Yakov Trenin,80,17,7,24,0.125,16.98
8478508,20202021,Yakov Trenin,45,5,6,11,0.081,5.84
8478508,20192020,Yakov Trenin,21,2,4,6,0.08,
8475692,20242025,Mats Zuccarello,69,19,35,54,0.125828,15.66
8475692,20232024,Mats Zuccarello,69,12,51,63,0.069364,15.12
8475692,20222023,Mats Zuccarello,78,22,45,67,0.111111,20.43
8475692,20212022,Mats Zuccarello,70,24,55,79,0.151,14.81
8475692,20202021,Mats Zuccarello,42,11,24,35,0.149,7.55
8475692,20192020,Mats Zuccarello,65,15,22,37,0.156,
8475692,20182019,Mats Zuccarello,2,1,2,3,0.2,
8475692,20172018,Mats Zuccarello,80,16,37,53,0.0899,
8475692,20162017,Mats Zuccarello,80,15,44,59,0.0794,
8475692,20152016,Mats Zuccarello,81,26,35,61,0.1566,
8475692,20142015,Mats Zuccarello,78,15,34,49,0.0974,
8475692,20132014,Mats Zuccarello,77,19,40,59,0.1118,
8475692,20122013,Mats Zuccarello,15,3,5,8,0.1111,
8475692,20112012,Mats Zuccarello,10,2,1,3,0.2,
8475692,20102011,Mats Zuccarello,42,6,17,23,0.0811,
8474567,20242025,Zach Bogosian,81,4,12,16,0.050633,2.46
8474567,20232024,Zach Bogosian,61,3,11,14,0.038961,2.79
8474567,20222023,Zach Bogosian,46,1,4,5,0.018519,2.02
8474567,20212022,Zach Bogosian,48,3,5,8,0.05,2.26
8474567,20202021,Zach Bogosian,45,0,4,4,0.0,1.67
8474567,20192020,Zach Bogosian,8,0,2,2,0.0,
8474567,20182019,Zach Bogosian,65,3,16,19,0.0323,
8474567,20172018,Zach Bogosian,18,0,1,1,0.0,
8474567,20162017,Zach Bogosian,56,2,9,11,0.0274,
8474567,20152016,Zach Bogosian,64,7,17,24,0.0579,
8474567,20142015,Zach Bogosian,21,0,7,7,0.0,
8474567,20132014,Zach Bogosian,55,3,8,11,0.0224,
8474567,20122013,Zach Bogosian,33,5,9,14,0.0588,
8474567,20112012,Zach Bogosian,65,5,25,30,0.0333,
8474567,20102011,Zach Bogosian,71,5,12,17,0.0323,
8474567,20092010,Zach Bogosian,81,10,13,23,0.0645,
8474567,20082009,Zach Bogosian,47,9,10,19,0.1,
8476463,20242025,Jonas Brodin,50,4,16,20,0.056338,2.23
8476463,20232024,Jonas Brodin,62,7,20,27,0.059829,5.7
8476463,20222023,Jonas Brodin,60,3,11,14,0.033333,4.26
8476463,20212022,Jonas Brodin,73,5,25,30,0.04,4.91
8476463,20202021,Jonas Brodin,53,9,14,23,0.114,4.82
8476463,20192020,Jonas Brodin,69,2,26,28,0.019,
8476463,20182019,Jonas Brodin,82,4,14,18,0.036,
8476463,20172018,Jonas Brodin,73,6,15,21,0.0779,
8476463,20162017,Jonas Brodin,68,3,22,25,0.0353,
8476463,20152016,Jonas Brodin,68,2,5,7,0.0345,
8476463,20142015,Jonas Brodin,71,3,14,17,0.0316,
8476463,20132014,Jonas Brodin,79,8,11,19,0.1081,
8476463,20122013,Jonas Brodin,45,2,9,11,0.0392,
8478136,20242025,Jake Middleton,67,8,13,21,0.082474,4.97
8478136,20232024,Jake Middleton,80,7,18,25,0.082353,5.7
8478136,20222023,Jake Middleton,79,3,12,15,0.037975,5.9
8478136,20212022,Jake Middleton,21,1,4,5,0.045,3.94
8478136,20202021,Jake Middleton,1,0,0,0,0.0,0.04
8478136,20192020,Jake Middleton,10,0,2,2,0.0,
8478136,20182019,Jake Middleton,3,0,1,1,0.0,
8474716,20242025,Jared Spurgeon,66,7,25,32,0.065421,5.45
8474716,20232024,Jared Spurgeon,16,0,5,5,0.0,1.22
8474716,20222023,Jared Spurgeon,79,11,23,34,0.073826,8.97
8474716,20212022,Jared Spurgeon,65,10,30,40,0.086,5.8
8474716,20202021,Jared Spurgeon,54,7,18,25,0.074,7.19
8474716,20192020,Jared Spurgeon,62,12,20,32,0.107,
8474716,20182019,Jared Spurgeon,82,14,29,43,0.0921,
8474716,20172018,Jared Spurgeon,61,9,28,37,0.0818,
8474716,20162017,Jared Spurgeon,76,10,28,38,0.0694,
8474716,20152016,Jared Spurgeon,77,11,18,29,0.0902,
8474716,20142015,Jared Spurgeon,66,9,16,25,0.0703,
8474716,20132014,Jared Spurgeon,67,5,21,26,0.0549,
8474716,20122013,Jared Spurgeon,39,5,10,15,0.0746,
8474716,20112012,Jared Spurgeon,70,3,20,23,0.0326,
8474716,20102011,Jared Spurgeon,53,4,8,12,0.1053,
8476981,20242025,Josh Anderson,81,15,12,27,0.137615,17.17
8476981,20232024,Josh Anderson,78,9,11,20,0.06383,18.35
8476981,20222023,Josh Anderson,69,21,11,32,0.128049,24.21
8476981,20212022,Josh Anderson,69,19,13,32,0.126,18.71
8476981,20202021,Josh Anderson,52,17,7,24,0.136,14.2
8476981,20192020,Josh Anderson,26,1,3,4,0.016,
8476981,20182019,Josh Anderson,82,27,20,47,0.1174,
8476981,20172018,Josh Anderson,63,19,11,30,0.1011,
8476981,20162017,Josh Anderson,78,17,12,29,0.1429,
8476981,20152016,Josh Anderson,12,1,3,4,0.0909,
8476981,20142015,Josh Anderson,6,0,1,1,0.0,
8481540,20242025,Cole Caufield,82,37,33,70,0.154167,29.21
8481540,20232024,Cole Caufield,82,28,37,65,0.089172,30.64
8481540,20222023,Cole Caufield,46,26,10,36,0.164557,15.47
8481540,20212022,Cole Caufield,67,23,20,43,0.122,15.75
8481540,20202021,Cole Caufield,10,4,1,5,0.133,3.06
8481523,20242025,Kirby Dach,57,10,12,22,0.119048,10.86
8481523,20232024,Kirby Dach,2,0,2,2,0.0,0.3
8481523,20222023,Kirby Dach,58,14,24,38,0.130841,14.72
8481523,20212022,Kirby Dach,70,9,17,26,0.078,12.75
8481523,20202021,Kirby Dach,18,2,8,10,0.077,3.01
8481523,20192020,Kirby Dach,64,8,15,23,0.079,
8478133,20242025,Jake Evans,82,13,23,36,0.1625,14.69
8478133,20232024,Jake Evans,82,7,21,28,0.08642,9.45
8478133,20222023,Jake Evans,54,2,17,19,0.036364,6.8
8478133,20212022,Jake Evans,72,13,16,29,0.105,11.11
8478133,20202021,Jake Evans,47,3,10,13,0.055,5.21
8478133,20192020,Jake Evans,13,2,1,3,0.143,
8475848,20242025,Brendan Gallagher,82,21,17,38,0.141892,24.94
8475848,20232024,Brendan Gallagher,77,16,15,31,0.103896,21.55
8475848,20222023,Brendan Gallagher,37,8,6,14,0.086022,10.7
8475848,20212022,Brendan Gallagher,56,7,17,24,0.049,17.66
8475848,20202021,Brendan Gallagher,35,14,9,23,0.132,12.57
8475848,20192020,Brendan Gallagher,59,22,21,43,0.097,
8475848,20182019,Brendan Gallagher,82,33,19,52,0.1093,
8475848,20172018,Brendan Gallagher,82,31,23,54,0.1115,
8475848,20162017,Brendan Gallagher,64,10,19,29,0.0535,
8475848,20152016,Brendan Gallagher,53,19,21,40,0.1098,
8475848,20142015,Brendan Gallagher,82,24,23,47,0.0945,
8475848,20132014,Brendan Gallagher,81,19,22,41,0.09,
8475848,20122013,Brendan Gallagher,44,15,13,28,0.1282,
8479339,20242025,Patrik Laine,52,20,13,33,0.172414,11.86
8479339,20232024,Patrik Laine,18,6,3,9,0.146341,3.46
8479339,20222023,Patrik Laine,55,22,30,52,0.119565,18.04
8479339,20212022,Patrik Laine,56,26,30,56,0.156,17.56
8479339,20202021,Patrik Laine,45,10,11,21,0.127,5.46
8479339,20192020,Patrik Laine,68,28,35,63,0.124,
8479339,20182019,Patrik Laine,82,30,20,50,0.1224,
8479339,20172018,Patrik Laine,82,44,26,70,0.1826,
8479339,20162017,Patrik Laine,73,36,28,64,0.1765,
8481618,20242025,Alex Newhook,82,15,11,26,0.127119,17.93
8481618,20232024,Alex Newhook,55,15,19,34,0.176471,12.13
8481618,20222023,Alex Newhook,82,14,16,30,0.12069,14
8481618,20212022,Alex Newhook,71,13,20,33,0.115,10.86
8481618,20202021,Alex Newhook,6,0,3,3,0.0,0.96
8480018,20242025,Nick Suzuki,82,30,59,89,0.174419,19.51
8480018,20232024,Nick Suzuki,82,33,44,77,0.178378,21.76
8480018,20222023,Nick Suzuki,82,26,40,66,0.160494,18.09
8480018,20212022,Nick Suzuki,82,21,40,61,0.113,18.81
8480018,20202021,Nick Suzuki,56,15,26,41,0.136,12.29
8480018,20192020,Nick Suzuki,71,13,28,41,0.094,
8480813,20242025,Joe Veleno,18,3,4,7,0.12,8.24
8480813,20232024,Joe Veleno,80,12,16,28,0.139535,11.82
8480813,20222023,Joe Veleno,81,9,11,20,0.105882,8.31
8480813,20212022,Joe Veleno,66,8,7,15,0.11,6.95
8480813,20202021,Joe Veleno,5,1,0,1,0.125,1.47
8478851,20242025,Alexandre Carrier,51,2,16,18,0.033898,3.95
8478851,20232024,Alexandre Carrier,73,4,16,20,0.051948,4.1
8478851,20222023,Alexandre Carrier,43,2,7,9,0.041667,2.93
8478851,20212022,Alexandre Carrier,77,3,27,30,0.032,5.57
8478851,20202021,Alexandre Carrier,19,1,2,3,0.032,2.35
8478851,20192020,Alexandre Carrier,3,0,0,0,0.0,
8480865,20242025,Noah Dobson,71,10,29,39,0.05102,9.54
8480865,20232024,Noah Dobson,79,10,60,70,0.057471,6.46
8480865,20222023,Noah Dobson,78,13,36,49,0.063107,9.65
8480865,20212022,Noah Dobson,80,13,38,51,0.068,8.91
8480865,20202021,Noah Dobson,46,3,11,14,0.043,1.95
8480865,20192020,Noah Dobson,34,1,6,7,0.027,
8476875,20242025,Mike Matheson,80,6,25,31,0.040268,9.14
8476875,20232024,Mike Matheson,82,11,51,62,0.058824,10.16
8476875,20222023,Mike Matheson,48,8,26,34,0.063492,6.62
8476875,20212022,Mike Matheson,74,11,20,31,0.079,7.13
8476875,20202021,Mike Matheson,44,5,11,16,0.058,3.39
8476875,20192020,Mike Matheson,59,8,12,20,0.077,
8476875,20182019,Mike Matheson,75,8,19,27,0.062,
8476875,20172018,Mike Matheson,81,10,17,27,0.0599,
8476875,20162017,Mike Matheson,81,7,10,17,0.0391,
8476875,20152016,Mike Matheson,3,0,0,0,0.0,
8479407,20242025,Jesper Bratt,81,21,67,88,0.116667,26.19
8479407,20232024,Jesper Bratt,82,27,56,83,0.108871,32.01
8479407,20222023,Jesper Bratt,82,32,41,73,0.150943,26.58
8479407,20212022,Jesper Bratt,76,26,47,73,0.132,19.14
8479407,20202021,Jesper Bratt,46,7,23,30,0.069,10.39
8479407,20192020,Jesper Bratt,60,16,16,32,0.158,
8479407,20182019,Jesper Bratt,51,8,25,33,0.0879,
8479407,20172018,Jesper Bratt,74,13,22,35,0.13,
8477015,20242025,Connor Brown,82,13,17,30,0.105691,15.01
8477015,20232024,Connor Brown,71,4,8,12,0.037037,11.18
8477015,20222023,Connor Brown,4,0,0,0,0.0,0.45
8477015,20212022,Connor Brown,64,10,29,39,0.083,15.03
8477015,20202021,Connor Brown,56,21,14,35,0.171,13.39
8477015,20192020,Connor Brown,71,16,27,43,0.092,
8477015,20182019,Connor Brown,82,8,21,29,0.0941,
8477015,20172018,Connor Brown,82,14,14,28,0.1176,
8477015,20162017,Connor Brown,82,20,16,36,0.1439,
8477015,20152016,Connor Brown,7,1,5,6,0.0909,
8474149,20242025,Evgenii Dadonov,80,20,20,40,0.162602,18.84
8474149,20232024,Evgenii Dadonov,51,12,11,23,0.179104,9.01
8474149,20222023,Evgenii Dadonov,23,3,12,15,0.078947,13.26
8474149,20212022,Evgenii Dadonov,78,20,23,43,0.113,18.6
8474149,20202021,Evgenii Dadonov,55,13,7,20,0.146,10.3
8474149,20192020,Evgenii Dadonov,69,25,22,47,0.15,
8474149,20182019,Evgenii Dadonov,82,28,42,70,0.1436,
8474149,20172018,Evgenii Dadonov,74,28,37,65,0.1489,
8479996,20242025,Cody Glass,14,2,5,7,0.153846,10.08
8479996,20232024,Cody Glass,41,6,7,13,0.073171,9.04
8479996,20222023,Cody Glass,72,14,21,35,0.10687,15.34
8479996,20212022,Cody Glass,8,0,1,1,0.0,0.94
8479996,20202021,Cody Glass,27,4,6,10,0.143,4.72
8479996,20192020,Cody Glass,39,5,7,12,0.098,
8480002,20242025,Nico Hischier,75,35,34,69,0.187166,35.06
8480002,20232024,Nico Hischier,71,27,40,67,0.148352,28.57
8480002,20222023,Nico Hischier,81,31,49,80,0.121094,37.92
8480002,20212022,Nico Hischier,70,21,39,60,0.137,20.35
8480002,20202021,Nico Hischier,21,6,5,11,0.136,6
8480002,20192020,Nico Hischier,58,14,22,36,0.114,
8480002,20182019,Nico Hischier,69,17,30,47,0.1063,
8480002,20172018,Nico Hischier,82,20,32,52,0.1111,
8481559,20242025,Jack Hughes,62,27,43,70,0.117904,25.43
8481559,20232024,Jack Hughes,62,27,47,74,0.09854,25.69
8481559,20222023,Jack Hughes,78,43,56,99,0.127976,36.58
8481559,20212022,Jack Hughes,49,26,30,56,0.158,18.2
8481559,20202021,Jack Hughes,56,11,20,31,0.077,12.65
8481559,20192020,Jack Hughes,61,7,14,21,0.057,
8477073,20242025,Kurtis MacDermid,23,0,0,0,0.0,0.91
8477073,20232024,Kurtis MacDermid,16,0,1,1,0.0,1.49
8477073,20222023,Kurtis MacDermid,44,1,5,6,0.05,1.16
8477073,20212022,Kurtis MacDermid,58,2,3,5,0.043,2.68
8477073,20202021,Kurtis MacDermid,28,2,2,4,0.125,0.55
8477073,20192020,Kurtis MacDermid,45,3,5,8,0.059,
8477073,20182019,Kurtis MacDermid,11,0,1,1,0.0,
8477073,20172018,Kurtis MacDermid,34,1,3,4,0.0526,
8478414,20242025,Timo Meier,80,26,27,53,0.108787,29.98
8478414,20232024,Timo Meier,69,28,24,52,0.135266,26
8478414,20222023,Timo Meier,21,9,5,14,0.125,38.86
8478414,20212022,Timo Meier,77,35,41,76,0.107,31.03
8478414,20202021,Timo Meier,54,12,19,31,0.077,12.23
8478414,20192020,Timo Meier,70,22,27,49,0.111,
8478414,20182019,Timo Meier,78,30,36,66,0.12,
8478414,20172018,Timo Meier,81,21,15,36,0.1,
8478414,20162017,Timo Meier,34,3,3,6,0.0353,
8476474,20242025,Stefan Noesen,78,22,19,41,0.133333,28.52
8476474,20232024,Stefan Noesen,81,14,23,37,0.126126,16.84
8476474,20222023,Stefan Noesen,78,13,23,36,0.097015,21.42
8476474,20212022,Stefan Noesen,2,0,0,0,0.0,0.83
8476474,20202021,Stefan Noesen,1,0,0,0,0.0,0.24
8476474,20192020,Stefan Noesen,34,6,2,8,0.102,
8476474,20182019,Stefan Noesen,41,3,5,8,0.0469,
8476474,20172018,Stefan Noesen,72,13,14,27,0.1024,
8476474,20162017,Stefan Noesen,32,6,2,8,0.1176,
8476474,20152016,Stefan Noesen,1,0,0,0,0.0,
8476474,20142015,Stefan Noesen,1,0,0,0,0.0,
8476292,20242025,Ondrej Palat,77,15,13,28,0.15625,13.44
8476292,20232024,Ondrej Palat,71,11,20,31,0.101852,13.88
8476292,20222023,Ondrej Palat,49,8,15,23,0.101266,10.3
8476292,20212022,Ondrej Palat,77,18,31,49,0.126,18.39
8476292,20202021,Ondrej Palat,55,15,31,46,0.135,15.57
8476292,20192020,Ondrej Palat,69,17,24,41,0.133,
8476292,20182019,Ondrej Palat,64,8,26,34,0.08,
8476292,20172018,Ondrej Palat,56,11,24,35,0.1009,
8476292,20162017,Ondrej Palat,75,17,35,52,0.1049,
8476292,20152016,Ondrej Palat,62,16,24,40,0.1368,
8476292,20142015,Ondrej Palat,75,16,47,63,0.1151,
8476292,20132014,Ondrej Palat,81,23,36,59,0.1394,
8476292,20122013,Ondrej Palat,14,2,2,4,0.125,
8479395,20242025,Dennis Cholowski,6,0,0,0,0.0,1.02
8475455,20242025,Brenden Dillon,82,2,14,16,0.041667,3.47
8475455,20232024,Brenden Dillon,77,8,12,20,0.101266,2.9
8475455,20222023,Brenden Dillon,82,2,21,23,0.024096,3.15
8475455,20212022,Brenden Dillon,79,3,17,20,0.035,4.18
8475455,20202021,Brenden Dillon,56,2,17,19,0.039,1.65
8475455,20192020,Brenden Dillon,10,0,0,0,0.0,
8475455,20182019,Brenden Dillon,82,1,21,22,0.0141,
8475455,20172018,Brenden Dillon,81,5,17,22,0.0568,
8475455,20162017,Brenden Dillon,81,2,8,10,0.0233,
8475455,20152016,Brenden Dillon,76,2,9,11,0.0215,
8475455,20142015,Brenden Dillon,60,2,7,9,0.0267,
8475455,20132014,Brenden Dillon,80,6,11,17,0.0619,
8475455,20122013,Brenden Dillon,48,3,5,8,0.04,
8475455,20112012,Brenden Dillon,1,0,0,0,0.0,
8476462,20242025,Dougie Hamilton,64,9,31,40,0.048387,12.29
8476462,20232024,Dougie Hamilton,20,5,11,16,0.081967,3.51
8476462,20222023,Dougie Hamilton,82,22,52,74,0.08,13.43
8476462,20212022,Dougie Hamilton,62,9,21,30,0.046,11.35
8476462,20202021,Dougie Hamilton,55,10,32,42,0.056,7.84
8476462,20192020,Dougie Hamilton,47,14,26,40,0.082,
8476462,20182019,Dougie Hamilton,82,18,21,39,0.0695,
8476462,20172018,Dougie Hamilton,82,17,27,44,0.063,
8476462,20162017,Dougie Hamilton,81,13,37,50,0.0586,
8476462,20152016,Dougie Hamilton,82,12,31,43,0.0632,
8476462,20142015,Dougie Hamilton,72,10,32,42,0.0532,
8476462,20132014,Dougie Hamilton,64,7,18,25,0.0614,
8476462,20122013,Dougie Hamilton,42,5,11,16,0.0602,
8477488,20242025,Brett Pesce,72,3,14,17,0.030303,4.33
8477488,20232024,Brett Pesce,70,3,10,13,0.028037,5.79
8477488,20222023,Brett Pesce,82,5,25,30,0.034722,6.33
8477488,20212022,Brett Pesce,70,7,21,28,0.047,5.93
8477488,20202021,Brett Pesce,55,4,21,25,0.045,4.58
8477488,20192020,Brett Pesce,61,4,14,18,0.038,
8477488,20182019,Brett Pesce,73,7,22,29,0.0714,
8477488,20172018,Brett Pesce,65,3,16,19,0.0341,
8477488,20162017,Brett Pesce,82,2,18,20,0.0183,
8477488,20152016,Brett Pesce,69,4,12,16,0.0471,
8478399,20242025,Jonas Siegenthaler,55,2,7,9,0.038462,2.52
8478399,20232024,Jonas Siegenthaler,57,1,8,9,0.015873,2.68
8478399,20222023,Jonas Siegenthaler,80,4,17,21,0.047619,3.22
8478399,20212022,Jonas Siegenthaler,70,1,13,14,0.011,2.66
8478399,20202021,Jonas Siegenthaler,8,0,0,0,0.0,0.27
8478399,20192020,Jonas Siegenthaler,64,2,7,9,0.041,
8478399,20182019,Jonas Siegenthaler,26,0,4,4,0.0,
8478047,20242025,Michael Bunting,18,5,4,9,0.111111,25.19
8478047,20232024,Michael Bunting,21,6,13,19,0.109091,24.34
8478047,20222023,Michael Bunting,82,23,26,49,0.132184,28.04
8478047,20212022,Michael Bunting,79,23,40,63,0.131,25.16
8478047,20202021,Michael Bunting,21,10,3,13,0.263,6.68
8476887,20242025,Filip Forsberg,82,31,45,76,0.11032,32.29
8476887,20232024,Filip Forsberg,82,48,46,94,0.138329,38.77
8476887,20222023,Filip Forsberg,50,19,23,42,0.121019,20.14
8476887,20212022,Filip Forsberg,69,42,42,84,0.186,26.94
8476887,20202021,Filip Forsberg,39,12,20,32,0.093,11.27
8476887,20192020,Filip Forsberg,63,21,27,48,0.106,
8476887,20182019,Filip Forsberg,64,28,22,50,0.129,
8476887,20172018,Filip Forsberg,67,26,38,64,0.1453,
8476887,20162017,Filip Forsberg,82,31,27,58,0.1325,
8476887,20152016,Filip Forsberg,82,33,31,64,0.1336,
8476887,20142015,Filip Forsberg,82,26,37,63,0.1097,
8476887,20132014,Filip Forsberg,13,1,4,5,0.05,
8476887,20122013,Filip Forsberg,5,0,1,1,0.0,
8475287,20242025,Erik Haula,69,11,10,21,0.1,14.02
8475287,20232024,Erik Haula,76,16,19,35,0.103226,21.33
8475287,20222023,Erik Haula,80,14,27,41,0.085366,22.08
8475287,20212022,Erik Haula,78,18,26,44,0.128,16.08
8475287,20202021,Erik Haula,51,9,12,21,0.106,12.8
8475287,20192020,Erik Haula,7,0,2,2,0.0,
8475287,20182019,Erik Haula,15,2,5,7,0.0769,
8475287,20172018,Erik Haula,76,29,26,55,0.1657,
8475287,20162017,Erik Haula,72,15,11,26,0.1119,
8475287,20152016,Erik Haula,76,14,20,34,0.1414,
8475287,20142015,Erik Haula,72,7,7,14,0.0761,
8475287,20132014,Erik Haula,46,6,9,15,0.1071,
8476539,20242025,Jonathan Marchessault,78,21,35,56,0.101942,23.25
8476539,20232024,Jonathan Marchessault,82,42,27,69,0.157895,29.49
8476539,20222023,Jonathan Marchessault,76,28,29,57,0.119658,26
8476539,20212022,Jonathan Marchessault,76,30,36,66,0.12,24.36
8476539,20202021,Jonathan Marchessault,55,18,26,44,0.102,16.18
8476539,20192020,Jonathan Marchessault,66,22,25,47,0.094,
8476539,20182019,Jonathan Marchessault,82,25,34,59,0.0899,
8476539,20172018,Jonathan Marchessault,77,27,48,75,0.1007,
8476539,20162017,Jonathan Marchessault,75,30,21,51,0.1554,
8476539,20152016,Jonathan Marchessault,45,7,11,18,0.0864,
8476539,20142015,Jonathan Marchessault,2,1,0,1,0.3333,
8477446,20242025,Michael McCarron,74,5,9,14,0.0625,10.6
8477446,20232024,Michael McCarron,70,12,10,22,0.12766,12.16
8477446,20222023,Michael McCarron,32,2,2,4,0.051282,4.83
8477446,20212022,Michael McCarron,51,7,7,14,0.137,5.84
8477446,20202021,Michael McCarron,6,0,0,0,0.0,0.65
8475158,20242025,Ryan O'Reilly,79,21,32,53,0.139073,28.75
8475158,20232024,Ryan O'Reilly,82,26,43,69,0.144444,29.13
8475158,20222023,Ryan O'Reilly,13,4,7,11,0.181818,13.45
8475158,20212022,Ryan O'Reilly,78,21,37,58,0.125,23.2
8475158,20202021,Ryan O'Reilly,56,24,30,54,0.186,13.13
8475158,20192020,Ryan O'Reilly,71,12,49,61,0.102,
8475158,20182019,Ryan O'Reilly,82,28,49,77,0.1197,
8475158,20172018,Ryan O'Reilly,81,24,37,61,0.1043,
8475158,20162017,Ryan O'Reilly,72,20,35,55,0.1058,
8475158,20152016,Ryan O'Reilly,71,21,39,60,0.1338,
8475158,20142015,Ryan O'Reilly,82,17,38,55,0.0994,
8475158,20132014,Ryan O'Reilly,80,28,36,64,0.1393,
8475158,20122013,Ryan O'Reilly,29,6,14,20,0.0909,
8475158,20112012,Ryan O'Reilly,81,18,37,55,0.0952,
8475158,20102011,Ryan O'Reilly,74,13,13,26,0.1092,
8475158,20092010,Ryan O'Reilly,81,8,18,26,0.0593,
8482062,20242025,Cole Smith,71,4,8,12,0.057971,8.56
8482062,20232024,Cole Smith,80,9,14,23,0.080357,15.55
8482062,20222023,Cole Smith,69,4,13,17,0.0625,10.93
8482062,20212022,Cole Smith,8,0,0,0,0.0,0.26
8482062,20202021,Cole Smith,1,0,0,0,0.0,0.07
8474564,20242025,Steven Stamkos,82,27,26,53,0.155172,22.66
8474564,20232024,Steven Stamkos,79,40,41,81,0.152672,32.26
8474564,20222023,Steven Stamkos,81,34,50,84,0.141667,34.44
8474564,20212022,Steven Stamkos,81,42,64,106,0.174,26.74
8474564,20202021,Steven Stamkos,38,17,17,34,0.187,11.96
8474564,20192020,Steven Stamkos,57,29,37,66,0.165,
8474564,20182019,Steven Stamkos,82,45,53,98,0.1923,
8474564,20172018,Steven Stamkos,78,27,59,86,0.1274,
8474564,20162017,Steven Stamkos,17,9,11,20,0.1552,
8474564,20152016,Steven Stamkos,77,36,28,64,0.1667,
8474564,20142015,Steven Stamkos,82,43,29,72,0.1604,
8474564,20132014,Steven Stamkos,37,25,15,40,0.2016,
8474564,20122013,Steven Stamkos,48,29,28,57,0.1847,
8474564,20112012,Steven Stamkos,82,60,37,97,0.198,
8474564,20102011,Steven Stamkos,82,45,46,91,0.1654,
8474564,20092010,Steven Stamkos,82,51,44,95,0.1717,
8474564,20082009,Steven Stamkos,79,23,23,46,0.1271,
8477971,20242025,Andreas Englund,24,0,2,2,0.0,0.49
8477971,20232024,Andreas Englund,82,1,9,10,0.02439,1.45
8477971,20222023,Andreas Englund,11,0,1,1,0.0,1.24
8475857,20242025,Kevin Gravel,6,0,1,1,0.0,0.2
8479980,20242025,Nicolas Hague,68,5,7,12,0.067568,3.59
8479980,20232024,Nicolas Hague,73,2,10,12,0.019048,4.11
8479980,20222023,Nicolas Hague,81,3,14,17,0.029126,5.13
8479980,20212022,Nicolas Hague,52,4,10,14,0.034,4.79
8479980,20202021,Nicolas Hague,52,5,12,17,0.064,3.16
8479980,20192020,Nicolas Hague,38,1,10,11,0.019,
8474600,20242025,Roman Josi,53,9,29,38,0.06,13.44
8474600,20232024,Roman Josi,82,23,62,85,0.085821,16.69
8474600,20222023,Roman Josi,67,18,41,59,0.066914,17.7
8474600,20212022,Roman Josi,80,23,73,96,0.082,18.23
8474600,20202021,Roman Josi,48,8,25,33,0.057,7.48
8474600,20192020,Roman Josi,69,16,49,65,0.062,
8474600,20182019,Roman Josi,82,15,41,56,0.0547,
8474600,20172018,Roman Josi,75,14,39,53,0.0553,
8474600,20162017,Roman Josi,72,12,37,49,0.0553,
8474600,20152016,Roman Josi,81,14,47,61,0.0707,
8474600,20142015,Roman Josi,81,15,40,55,0.0746,
8474600,20132014,Roman Josi,72,13,27,40,0.0774,
8474600,20122013,Roman Josi,48,5,13,18,0.0521,
8474600,20112012,Roman Josi,52,5,11,16,0.0781,
8477851,20242025,Jordan Oesterle,15,3,1,4,0.166667,1.44
8477851,20232024,Jordan Oesterle,22,0,2,2,0.0,0.89
8477851,20222023,Jordan Oesterle,52,2,9,11,0.037037,2.26
8477851,20212022,Jordan Oesterle,45,2,6,8,0.032,1.9
8477851,20202021,Jordan Oesterle,43,1,10,11,0.026,2.42
8477851,20192020,Jordan Oesterle,58,3,10,13,0.043,
8477851,20182019,Jordan Oesterle,71,6,14,20,0.0779,
8477851,20172018,Jordan Oesterle,55,5,10,15,0.0505,
8477851,20162017,Jordan Oesterle,2,0,0,0,0.0,
8477851,20152016,Jordan Oesterle,17,0,5,5,0.0,
8477851,20142015,Jordan Oesterle,6,0,1,1,0.0,
8476869,20242025,Brady Skjei,82,10,23,33,0.064103,7.5
8476869,20232024,Brady Skjei,80,13,34,47,0.07027,9.77
8476869,20222023,Brady Skjei,81,18,20,38,0.095745,10.07
8476869,20212022,Brady Skjei,82,9,30,39,0.049,8.79
8476869,20202021,Brady Skjei,52,3,7,10,0.029,4.12
8476869,20192020,Brady Skjei,7,0,1,1,0.0,
8476869,20182019,Brady Skjei,78,8,17,25,0.0635,
8476869,20172018,Brady Skjei,82,4,21,25,0.0261,
8476869,20162017,Brady Skjei,80,5,34,39,0.0394,
8476869,20152016,Brady Skjei,7,0,0,0,0.0,
8478445,20242025,Mathew Barzal,30,6,14,20,0.076923,8.2
8478445,20232024,Mathew Barzal,80,23,57,80,0.095833,20.11
8478445,20222023,Mathew Barzal,58,14,37,51,0.100719,13.37
8478445,20212022,Mathew Barzal,73,15,44,59,0.093,15.65
8478445,20202021,Mathew Barzal,55,17,28,45,0.127,14.26
8478445,20192020,Mathew Barzal,68,19,41,60,0.111,
8478445,20182019,Mathew Barzal,82,18,44,62,0.1006,
8478445,20172018,Mathew Barzal,82,22,63,85,0.1294,
8478445,20162017,Mathew Barzal,2,0,0,0,0.0,
8475231,20242025,Casey Cizikas,82,7,10,17,0.072165,11.71
8475231,20232024,Casey Cizikas,70,10,13,23,0.121951,9.86
8475231,20222023,Casey Cizikas,81,6,15,21,0.054054,13.67
8475231,20212022,Casey Cizikas,74,10,6,16,0.11,9.78
8475231,20202021,Casey Cizikas,56,7,7,14,0.097,7.43
8475231,20192020,Casey Cizikas,48,10,4,14,0.149,
8475231,20182019,Casey Cizikas,73,20,13,33,0.1802,
8475231,20172018,Casey Cizikas,64,7,10,17,0.0946,
8475231,20162017,Casey Cizikas,59,8,17,25,0.0976,
8475231,20152016,Casey Cizikas,80,8,21,29,0.0952,
8475231,20142015,Casey Cizikas,70,9,9,18,0.1,
8475231,20132014,Casey Cizikas,80,6,10,16,0.0759,
8475231,20122013,Casey Cizikas,45,6,9,15,0.1333,
8475231,20112012,Casey Cizikas,15,0,4,4,0.0,
8477494,20242025,Jonathan Drouin,43,11,26,37,0.196429,7.23
8477494,20232024,Jonathan Drouin,79,19,37,56,0.149606,18.15
8477494,20222023,Jonathan Drouin,58,2,27,29,0.028986,7.56
8477494,20212022,Jonathan Drouin,34,6,14,20,0.097,4.64
8477494,20202021,Jonathan Drouin,44,2,21,23,0.026,6.23
8477494,20192020,Jonathan Drouin,27,7,8,15,0.137,
8477494,20182019,Jonathan Drouin,81,18,35,53,0.0947,
8477494,20172018,Jonathan Drouin,77,13,33,46,0.0793,
8477494,20162017,Jonathan Drouin,73,21,32,53,0.1148,
8477494,20152016,Jonathan Drouin,21,4,6,10,0.16,
8477494,20142015,Jonathan Drouin,70,4,28,32,0.0526,
8477407,20242025,Anthony Duclair,44,7,4,11,0.116667,6.61
8477407,20232024,Anthony Duclair,17,8,7,15,0.258065,18.97
8477407,20222023,Anthony Duclair,20,2,7,9,0.046512,6.85
8477407,20212022,Anthony Duclair,74,31,27,58,0.186,22.95
8477407,20202021,Anthony Duclair,43,10,22,32,0.096,11.75
8477407,20192020,Anthony Duclair,66,23,17,40,0.125,
8477407,20182019,Anthony Duclair,21,8,6,14,0.2,
8477407,20172018,Anthony Duclair,23,2,6,8,0.069,
8477407,20162017,Anthony Duclair,58,5,10,15,0.0658,
8477407,20152016,Anthony Duclair,81,20,24,44,0.1905,
8477407,20142015,Anthony Duclair,18,1,6,7,0.0556,
8478115,20242025,Pierre Engvall,62,8,7,15,0.086022,7.95
8478115,20232024,Pierre Engvall,74,10,18,28,0.078125,16.52
8478115,20222023,Pierre Engvall,18,5,4,9,0.16129,14.59
8478115,20212022,Pierre Engvall,78,15,20,35,0.097,17.2
8478115,20202021,Pierre Engvall,42,7,5,12,0.115,5.83
8478115,20192020,Pierre Engvall,48,8,7,15,0.111,
8479328,20242025,Julien Gauthier,1,0,0,0,0.0,0
8479328,20232024,Julien Gauthier,27,5,4,9,0.15625,3.44
8479328,20222023,Julien Gauthier,17,3,2,5,0.176471,5.46
8479328,20212022,Julien Gauthier,49,3,4,7,0.043,10.37
8479328,20202021,Julien Gauthier,30,2,6,8,0.053,3.37
8479328,20192020,Julien Gauthier,12,0,2,2,0.0,
8477500,20242025,Bo Horvat,81,28,29,57,0.115226,26.33
8477500,20232024,Bo Horvat,81,33,35,68,0.133065,23.4
8477500,20222023,Bo Horvat,30,7,9,16,0.081395,29.06
8477500,20212022,Bo Horvat,70,31,21,52,0.16,25.74
8477500,20202021,Bo Horvat,56,19,20,39,0.145,15.8
8477500,20192020,Bo Horvat,69,22,31,53,0.124,
8477500,20182019,Bo Horvat,82,27,34,61,0.1189,
8477500,20172018,Bo Horvat,64,22,22,44,0.1392,
8477500,20162017,Bo Horvat,81,20,32,52,0.1266,
8477500,20152016,Bo Horvat,82,16,24,40,0.1032,
8477500,20142015,Bo Horvat,68,13,12,25,0.1398,
8475314,20242025,Anders Lee,82,29,25,54,0.124464,34.76
8475314,20232024,Anders Lee,81,20,17,37,0.108108,35.77
8475314,20222023,Anders Lee,82,28,22,50,0.130841,36.6
8475314,20212022,Anders Lee,76,28,18,46,0.176,24.07
8475314,20202021,Anders Lee,27,12,7,19,0.15,10.16
8475314,20192020,Anders Lee,68,20,23,43,0.103,
8475314,20182019,Anders Lee,82,28,23,51,0.1373,
8475314,20172018,Anders Lee,82,40,22,62,0.1923,
8475314,20162017,Anders Lee,81,34,18,52,0.178,
8475314,20152016,Anders Lee,80,15,21,36,0.082,
8475314,20142015,Anders Lee,76,25,16,41,0.1269,
8475314,20132014,Anders Lee,22,9,5,14,0.1324,
8475314,20122013,Anders Lee,2,1,1,2,0.5,
8476419,20242025,Jean-Gabriel Pageau,79,14,28,42,0.116667,20.58
8476419,20232024,Jean-Gabriel Pageau,82,11,22,33,0.108911,13.67
8476419,20222023,Jean-Gabriel Pageau,70,13,27,40,0.105691,18.71
8476419,20212022,Jean-Gabriel Pageau,77,18,21,39,0.143,14.21
8476419,20202021,Jean-Gabriel Pageau,54,14,14,28,0.173,10.82
8476419,20192020,Jean-Gabriel Pageau,7,2,0,2,0.125,
8476419,20182019,Jean-Gabriel Pageau,39,4,8,12,0.0482,
8476419,20172018,Jean-Gabriel Pageau,78,14,15,29,0.0952,
8476419,20162017,Jean-Gabriel Pageau,82,12,21,33,0.071,
8476419,20152016,Jean-Gabriel Pageau,82,19,24,43,0.1429,
8476419,20142015,Jean-Gabriel Pageau,50,10,9,19,0.1031,
8476419,20132014,Jean-Gabriel Pageau,28,2,0,2,0.0645,
8476419,20122013,Jean-Gabriel Pageau,9,2,2,4,0.1429,
8475151,20242025,Kyle Palmieri,82,24,24,48,0.142012,23.5
8475151,20232024,Kyle Palmieri,82,30,24,54,0.137615,28.71
8475151,20222023,Kyle Palmieri,55,16,17,33,0.131148,16.1
8475151,20212022,Kyle Palmieri,69,15,18,33,0.096,18.03
8475151,20202021,Kyle Palmieri,17,2,2,4,0.065,14.54
8475151,20192020,Kyle Palmieri,65,25,20,45,0.161,
8475151,20182019,Kyle Palmieri,74,27,23,50,0.1205,
8475151,20172018,Kyle Palmieri,62,24,20,44,0.1326,
8475151,20162017,Kyle Palmieri,80,26,27,53,0.1354,
8475151,20152016,Kyle Palmieri,82,30,27,57,0.1351,
8475151,20142015,Kyle Palmieri,57,14,15,29,0.125,
8475151,20132014,Kyle Palmieri,71,14,17,31,0.0952,
8475151,20122013,Kyle Palmieri,42,10,11,21,0.1087,
8475151,20112012,Kyle Palmieri,18,4,3,7,0.1176,
8475151,20102011,Kyle Palmieri,10,1,0,1,0.1,
8480871,20242025,Adam Boqvist,17,2,6,8,0.105263,2.49
8480871,20232024,Adam Boqvist,35,1,9,10,0.022222,3.07
8480871,20222023,Adam Boqvist,46,5,19,24,0.073529,2.96
8480871,20212022,Adam Boqvist,52,11,11,22,0.172,4.9
8480871,20202021,Adam Boqvist,35,2,14,16,0.051,2.97
8480871,20192020,Adam Boqvist,41,4,9,13,0.08,
8477950,20242025,Tony DeAngelo,35,4,15,19,0.052632,3.28
8477950,20232024,Tony DeAngelo,31,3,8,11,0.068182,1.52
8477950,20222023,Tony DeAngelo,70,11,31,42,0.063218,9.5
8477950,20212022,Tony DeAngelo,64,10,41,51,0.066,6.83
8477950,20202021,Tony DeAngelo,6,0,1,1,0.0,0.31
8477950,20192020,Tony DeAngelo,68,15,38,53,0.101,
8477950,20182019,Tony DeAngelo,61,4,26,30,0.036,
8477950,20172018,Tony DeAngelo,32,0,8,8,0.0,
8477950,20162017,Tony DeAngelo,39,5,9,14,0.0833,
8476429,20242025,Scott Mayfield,66,3,6,9,0.058824,2.6
8476429,20232024,Scott Mayfield,41,0,5,5,0.0,1.12
8476429,20222023,Scott Mayfield,82,6,18,24,0.05042,4.66
8476429,20212022,Scott Mayfield,61,3,15,18,0.038,3.55
8476429,20202021,Scott Mayfield,56,2,13,15,0.025,2.61
8476429,20192020,Scott Mayfield,67,5,8,13,0.051,
8476429,20182019,Scott Mayfield,79,4,15,19,0.0385,
8476429,20172018,Scott Mayfield,47,2,10,12,0.0345,
8476429,20162017,Scott Mayfield,25,2,7,9,0.0513,
8476429,20152016,Scott Mayfield,6,1,0,1,0.25,
8476917,20242025,Adam Pelech,60,0,21,21,0.0,5.15
8476917,20232024,Adam Pelech,58,1,15,16,0.014085,3.41
8476917,20222023,Adam Pelech,61,6,15,21,0.061856,4.57
8476917,20212022,Adam Pelech,78,3,25,28,0.029,4.76
8476917,20202021,Adam Pelech,56,4,10,14,0.049,4.12
8476917,20192020,Adam Pelech,38,1,8,9,0.02,
8476917,20182019,Adam Pelech,78,5,16,21,0.0455,
8476917,20172018,Adam Pelech,78,3,16,19,0.0283,
8476917,20162017,Adam Pelech,44,3,7,10,0.075,
8476917,20152016,Adam Pelech,9,0,2,2,0.0,
8477506,20242025,Ryan Pulock,74,5,18,23,0.051546,4.41
8477506,20232024,Ryan Pulock,58,5,14,19,0.055556,3.98
8477506,20222023,Ryan Pulock,82,5,21,26,0.039683,5.04
8477506,20212022,Ryan Pulock,56,5,16,21,0.041,5.85
8477506,20202021,Ryan Pulock,56,2,15,17,0.017,4.55
8477506,20192020,Ryan Pulock,68,10,25,35,0.061,
8477506,20182019,Ryan Pulock,82,9,28,37,0.05,
8477506,20172018,Ryan Pulock,68,10,22,32,0.0543,
8477506,20162017,Ryan Pulock,1,0,0,0,0.0,
8477506,20152016,Ryan Pulock,15,2,2,4,0.1333,
8481014,20242025,Alexander Romanov,64,4,16,20,0.04,3.82
8481014,20232024,Alexander Romanov,81,7,15,22,0.059829,3.44
8481014,20222023,Alexander Romanov,76,2,20,22,0.02,3.59
8481014,20212022,Alexander Romanov,79,3,10,13,0.028,3.32
8481014,20202021,Alexander Romanov,54,1,5,6,0.014,2.66
8477380,20242025,Jonny Brodzinski,51,12,7,19,0.164384,7.79
8477380,20232024,Jonny Brodzinski,57,6,13,19,0.067416,6.76
8477380,20222023,Jonny Brodzinski,17,1,1,2,0.037037,1.82
8477380,20212022,Jonny Brodzinski,22,1,1,2,0.029,2
8477380,20202021,Jonny Brodzinski,5,1,0,1,0.143,0.3
8477380,20192020,Jonny Brodzinski,3,0,1,1,0.0,
8477380,20182019,Jonny Brodzinski,13,2,1,3,0.1176,
8477380,20172018,Jonny Brodzinski,35,4,2,6,0.0755,
8477380,20162017,Jonny Brodzinski,6,0,2,2,0.0,
8475842,20242025,Sam Carrick,80,6,14,20,0.071429,10.43
8475842,20232024,Sam Carrick,16,2,3,5,0.133333,11.04
8475842,20222023,Sam Carrick,52,3,4,7,0.06,3.88
8475842,20212022,Sam Carrick,64,11,8,19,0.138,8.32
8475842,20202021,Sam Carrick,13,2,4,6,0.087,1.72
8475842,20192020,Sam Carrick,9,1,1,2,0.063,
8475842,20182019,Sam Carrick,6,0,1,1,0.0,
8475413,20242025,Justin Dowling,52,2,5,7,0.058824,4.49
8475413,20232024,Justin Dowling,2,1,0,1,0.333333,0.49
8482109,20242025,Alexis Lafrenière,82,17,28,45,0.111111,17
8482109,20232024,Alexis Lafrenière,82,28,29,57,0.129032,26.9
8482109,20222023,Alexis Lafrenière,81,16,23,39,0.118519,16.31
8482109,20212022,Alexis Lafrenière,79,19,12,31,0.173,11.4
8482109,20202021,Alexis Lafrenière,56,12,9,21,0.179,7.46
8476468,20242025,J.T. Miller,32,13,22,35,0.236364,21.36
8476468,20232024,J.T. Miller,81,37,66,103,0.190722,28.31
8476468,20222023,J.T. Miller,81,32,50,82,0.143498,24.64
8476468,20212022,J.T. Miller,80,32,67,99,0.155,28.79
8476468,20202021,J.T. Miller,53,15,31,46,0.142,13.57
8476468,20192020,J.T. Miller,69,27,45,72,0.164,
8476468,20182019,J.T. Miller,75,13,34,47,0.1204,
8476468,20172018,J.T. Miller,19,10,8,18,0.2222,
8476468,20162017,J.T. Miller,82,22,34,56,0.1667,
8476468,20152016,J.T. Miller,82,22,21,43,0.163,
8476468,20142015,J.T. Miller,58,10,13,23,0.1087,
8476468,20132014,J.T. Miller,30,3,3,6,0.0652,
8476468,20122013,J.T. Miller,26,2,2,4,0.0465,
8478550,20242025,Artemi Panarin,80,37,52,89,0.156118,25.37
8478550,20232024,Artemi Panarin,82,49,71,120,0.161716,30.61
8478550,20222023,Artemi Panarin,82,29,63,92,0.142157,17.26
8478550,20212022,Artemi Panarin,75,22,74,96,0.124,17.7
8478550,20202021,Artemi Panarin,42,17,41,58,0.16,10.35
8478550,20192020,Artemi Panarin,69,32,63,95,0.153,
8478550,20182019,Artemi Panarin,79,28,59,87,0.1466,
8478550,20172018,Artemi Panarin,81,27,55,82,0.1184,
8478550,20162017,Artemi Panarin,82,31,43,74,0.1469,
8478550,20152016,Artemi Panarin,80,30,47,77,0.1604,
8476389,20242025,Vincent Trocheck,82,26,33,59,0.128713,29.11
8476389,20232024,Vincent Trocheck,82,25,52,77,0.116279,33.38
8476389,20222023,Vincent Trocheck,82,22,42,64,0.097778,28.62
8476389,20212022,Vincent Trocheck,81,21,30,51,0.125,25.09
8476389,20202021,Vincent Trocheck,47,17,26,43,0.138,14.93
8476389,20192020,Vincent Trocheck,7,1,1,2,0.083,
8476389,20182019,Vincent Trocheck,55,10,24,34,0.0633,
8476389,20172018,Vincent Trocheck,82,31,44,75,0.108,
8476389,20162017,Vincent Trocheck,82,23,31,54,0.1,
8476389,20152016,Vincent Trocheck,76,25,28,53,0.1437,
8476389,20142015,Vincent Trocheck,50,7,15,22,0.0787,
8476389,20132014,Vincent Trocheck,20,5,3,8,0.1316,
8476459,20242025,Mika Zibanejad,82,20,42,62,0.10929,24.53
8476459,20232024,Mika Zibanejad,81,26,46,72,0.117647,25.94
8476459,20222023,Mika Zibanejad,82,39,52,91,0.155378,30.49
8476459,20212022,Mika Zibanejad,81,29,52,81,0.132,28.61
8476459,20202021,Mika Zibanejad,56,24,26,50,0.14,20.24
8476459,20192020,Mika Zibanejad,57,41,34,75,0.197,
8476459,20182019,Mika Zibanejad,82,30,44,74,0.1271,
8476459,20172018,Mika Zibanejad,72,27,20,47,0.1274,
8476459,20162017,Mika Zibanejad,56,14,23,37,0.1176,
8476459,20152016,Mika Zibanejad,81,21,30,51,0.1141,
8476459,20142015,Mika Zibanejad,80,20,26,46,0.1333,
8476459,20132014,Mika Zibanejad,69,16,17,33,0.1046,
8476459,20122013,Mika Zibanejad,42,7,13,20,0.0778,
8476459,20112012,Mika Zibanejad,9,0,1,1,0.0,
8478840,20242025,Will Borgen,51,4,9,13,0.070175,3.01
8478840,20232024,Will Borgen,82,3,22,25,0.030928,3.84
8478840,20222023,Will Borgen,82,3,17,20,0.039474,2.88
8478840,20212022,Will Borgen,36,2,6,8,0.041,1.5
8478840,20202021,Will Borgen,10,0,0,0,0.0,0.21
8479323,20242025,Adam Fox,74,10,51,61,0.074074,12.52
8479323,20232024,Adam Fox,72,17,56,73,0.124088,9.8
8479323,20222023,Adam Fox,82,12,60,72,0.075472,9.73
8479323,20212022,Adam Fox,78,11,63,74,0.07,7.06
8479323,20202021,Adam Fox,55,5,42,47,0.049,6.74
8479323,20192020,Adam Fox,70,8,34,42,0.064,
8478882,20242025,Vladislav Gavrikov,82,5,25,30,0.044643,5.98
8478882,20232024,Vladislav Gavrikov,77,6,17,23,0.052632,5.42
8478882,20222023,Vladislav Gavrikov,20,3,6,9,0.107143,6.68
8478882,20212022,Vladislav Gavrikov,80,5,28,33,0.046,7.88
8478882,20202021,Vladislav Gavrikov,55,2,10,12,0.042,2.13
8478882,20192020,Vladislav Gavrikov,69,5,13,18,0.062,
8482067,20242025,Connor Mackey,2,0,0,0,0.0,0.02
8482067,20232024,Connor Mackey,1,0,0,0,0.0,0.01
8482067,20222023,Connor Mackey,20,1,3,4,0.043478,1.25
8482067,20212022,Connor Mackey,3,0,1,1,0.0,0.25
8482067,20202021,Connor Mackey,6,1,2,3,0.25,0.46
8477369,20242025,Carson Soucy,16,1,2,3,0.052632,3.13
8477369,20232024,Carson Soucy,40,2,4,6,0.068966,1.94
8477369,20222023,Carson Soucy,78,3,13,16,0.034483,3.29
8477369,20212022,Carson Soucy,64,10,11,21,0.103,4.24
8477369,20202021,Carson Soucy,50,1,16,17,0.021,1.75
8477369,20192020,Carson Soucy,55,7,7,14,0.115,
8480001,20242025,Urho Vaakanainen,46,2,13,15,0.051282,2.02
8480001,20232024,Urho Vaakanainen,68,1,13,14,0.014925,1.69
8480001,20222023,Urho Vaakanainen,23,0,2,2,0.0,0.84
8480001,20212022,Urho Vaakanainen,14,0,2,2,0.0,1.18
8480001,20202021,Urho Vaakanainen,9,0,2,2,0.0,0.41
8480001,20192020,Urho Vaakanainen,5,0,0,0,0.0,
8480001,20182019,Urho Vaakanainen,2,0,0,0,0.0,
8478020,20242025,Michael Amadio,72,11,16,27,0.129412,13.32
8478020,20232024,Michael Amadio,73,14,13,27,0.119658,13.02
8478020,20222023,Michael Amadio,67,16,11,27,0.161616,11.2
8478020,20212022,Michael Amadio,53,11,7,18,0.177,7.1
8478020,20202021,Michael Amadio,5,0,1,1,0.0,2.47
8478020,20192020,Michael Amadio,68,6,10,16,0.061,
8478020,20182019,Michael Amadio,43,6,7,13,0.1622,
8478020,20172018,Michael Amadio,37,4,4,8,0.1429,
8480208,20242025,Drake Batherson,82,26,42,68,0.135417,21.66
8480208,20232024,Drake Batherson,82,28,38,66,0.142857,24.22
8480208,20222023,Drake Batherson,82,22,40,62,0.088353,33.2
8480208,20212022,Drake Batherson,46,17,27,44,0.155,11.66
8480208,20202021,Drake Batherson,56,17,17,34,0.153,15.31
8480208,20192020,Drake Batherson,23,3,7,10,0.094,
8480208,20182019,Drake Batherson,20,3,6,9,0.1667,
8476393,20242025,Nick Cousins,50,6,9,15,0.088235,7.67
8476393,20232024,Nick Cousins,69,7,8,15,0.063063,10.53
8476393,20222023,Nick Cousins,79,9,18,27,0.088235,9.62
8476393,20212022,Nick Cousins,68,9,13,22,0.087,11.08
8476393,20202021,Nick Cousins,52,5,13,18,0.083,5.18
8476393,20192020,Nick Cousins,7,1,2,3,0.1,
8476393,20182019,Nick Cousins,81,7,20,27,0.0486,
8476393,20172018,Nick Cousins,71,12,7,19,0.1008,
8476393,20162017,Nick Cousins,60,6,10,16,0.0606,
8476393,20152016,Nick Cousins,36,6,5,11,0.1463,
8476393,20142015,Nick Cousins,11,0,0,0,0.0,
8481528,20242025,Dylan Cozens,21,5,11,16,0.102041,22.91
8481528,20232024,Dylan Cozens,79,18,29,47,0.09,23.41
8481528,20222023,Dylan Cozens,81,31,37,68,0.146919,25.79
8481528,20212022,Dylan Cozens,79,13,25,38,0.081,16.17
8481528,20202021,Dylan Cozens,41,4,9,13,0.065,6.17
8474189,20242025,Lars Eller,63,6,9,15,0.077922,11.81
8474189,20232024,Lars Eller,82,15,16,31,0.097403,18.43
8474189,20222023,Lars Eller,24,3,4,7,0.076923,13.15
8474189,20212022,Lars Eller,72,13,18,31,0.112,10.79
8474189,20202021,Lars Eller,44,8,15,23,0.116,9.54
8474189,20192020,Lars Eller,69,16,23,39,0.106,
8474189,20182019,Lars Eller,81,13,23,36,0.0798,
8474189,20172018,Lars Eller,81,18,20,38,0.1118,
8474189,20162017,Lars Eller,81,12,13,25,0.1043,
8474189,20152016,Lars Eller,79,13,13,26,0.0872,
8474189,20142015,Lars Eller,77,15,12,27,0.1,
8474189,20132014,Lars Eller,77,12,14,26,0.0876,
8474189,20122013,Lars Eller,46,8,22,30,0.0952,
8474189,20112012,Lars Eller,79,16,12,28,0.124,
8474189,20102011,Lars Eller,77,7,10,17,0.0886,
8474189,20092010,Lars Eller,7,2,0,2,0.25,
8473512,20242025,Claude Giroux,81,15,35,50,0.108696,14.07
8473512,20232024,Claude Giroux,82,21,43,64,0.114754,18.11
8473512,20222023,Claude Giroux,82,35,44,79,0.163551,25.26
8473512,20212022,Claude Giroux,18,3,20,23,0.059,17.46
8473512,20202021,Claude Giroux,54,16,27,43,0.133,12.58
8473512,20192020,Claude Giroux,69,21,32,53,0.107,
8473512,20182019,Claude Giroux,82,22,63,85,0.0961,
8473512,20172018,Claude Giroux,82,34,68,102,0.1762,
8473512,20162017,Claude Giroux,82,14,44,58,0.0704,
8473512,20152016,Claude Giroux,78,22,45,67,0.0913,
8473512,20142015,Claude Giroux,81,25,48,73,0.0896,
8473512,20132014,Claude Giroux,82,28,58,86,0.1256,
8473512,20122013,Claude Giroux,48,13,35,48,0.0949,
8473512,20112012,Claude Giroux,77,28,65,93,0.1157,
8473512,20102011,Claude Giroux,82,25,51,76,0.1479,
8473512,20092010,Claude Giroux,82,16,31,47,0.1103,
8473512,20082009,Claude Giroux,42,9,18,27,0.1343,
8473512,20072008,Claude Giroux,2,0,0,0,0.0,
8480890,20242025,Jan Jenik,2,0,0,0,0.0,0
8480890,20232024,Jan Jenik,5,0,1,1,0.0,0.12
8480890,20222023,Jan Jenik,2,0,0,0,0.0,0
8480890,20212022,Jan Jenik,13,2,1,3,0.091,1.84
8480890,20202021,Jan Jenik,2,2,0,2,0.667,1.07
8481560,20242025,Arthur Kaliyev,14,3,1,4,0.142857,1.8
8481560,20232024,Arthur Kaliyev,51,7,8,15,0.069307,10.58
8481560,20222023,Arthur Kaliyev,56,13,15,28,0.106557,14.52
8481560,20212022,Arthur Kaliyev,80,14,13,27,0.072,16.02
8481560,20202021,Arthur Kaliyev,1,1,0,1,1.0,0.36
8479772,20242025,Zack MacEwen,21,2,1,3,0.076923,1.91
8479772,20232024,Zack MacEwen,30,2,1,3,0.117647,1.71
8479772,20222023,Zack MacEwen,10,0,1,1,0.0,7.49
8479772,20212022,Zack MacEwen,75,3,6,9,0.037,8.69
8479772,20202021,Zack MacEwen,34,1,1,2,0.032,2.73
8479772,20192020,Zack MacEwen,17,5,1,6,0.294,
8479772,20182019,Zack MacEwen,4,0,1,1,0.0,
8474102,20242025,David Perron,43,9,7,16,0.126761,9.8
8474102,20232024,David Perron,76,17,30,47,0.112583,16.68
8474102,20222023,David Perron,82,24,32,56,0.123077,20.78
8474102,20212022,David Perron,67,27,30,57,0.153,18.36
8474102,20202021,David Perron,56,19,39,58,0.126,11.57
8474102,20192020,David Perron,71,25,35,60,0.151,
8474102,20182019,David Perron,57,23,23,46,0.2054,
8474102,20172018,David Perron,70,16,50,66,0.128,
8474102,20162017,David Perron,82,18,28,46,0.1192,
8474102,20152016,David Perron,28,8,12,20,0.1569,
8474102,20142015,David Perron,43,12,10,22,0.0984,
8474102,20132014,David Perron,78,28,29,57,0.1273,
8474102,20122013,David Perron,48,10,15,25,0.119,
8474102,20112012,David Perron,57,21,21,42,0.1842,
8474102,20102011,David Perron,10,5,2,7,0.1724,
8474102,20092010,David Perron,82,20,27,47,0.1205,
8474102,20082009,David Perron,81,15,35,50,0.0932,
8474102,20072008,David Perron,62,13,14,27,0.1912,
8481596,20242025,Shane Pinto,70,21,16,37,0.165354,24.53
8481596,20232024,Shane Pinto,41,9,18,27,0.081818,14.73
8481596,20222023,Shane Pinto,82,20,15,35,0.126582,22.27
8481596,20212022,Shane Pinto,5,0,1,1,0.0,0.95
8481596,20202021,Shane Pinto,12,1,6,7,0.091,1.6
8482116,20242025,Tim Stützle,82,24,55,79,0.148148,20.2
8482116,20232024,Tim Stützle,75,18,52,70,0.09375,23.52
8482116,20222023,Tim Stützle,78,39,51,90,0.171053,32.58
8482116,20212022,Tim Stützle,79,22,36,58,0.125,25.97
8482116,20202021,Tim Stützle,53,12,17,29,0.108,7.83
8480801,20242025,Brady Tkachuk,72,29,26,55,0.097973,36.7
8480801,20232024,Brady Tkachuk,81,37,37,74,0.103641,40.94
8480801,20222023,Brady Tkachuk,82,35,48,83,0.100865,46.9
8480801,20212022,Brady Tkachuk,79,30,37,67,0.104,33.46
8480801,20202021,Brady Tkachuk,56,17,19,36,0.077,23.59
8480801,20192020,Brady Tkachuk,71,21,23,44,0.081,
8480801,20182019,Brady Tkachuk,71,22,23,45,0.1028,
8478469,20242025,Thomas Chabot,80,9,36,45,0.050279,8.45
8478469,20232024,Thomas Chabot,51,9,21,30,0.076271,6.74
8478469,20222023,Thomas Chabot,68,11,30,41,0.066667,9.33
8478469,20212022,Thomas Chabot,59,7,31,38,0.04,10.22
8478469,20202021,Thomas Chabot,49,6,25,31,0.05,5.48
8478469,20192020,Thomas Chabot,71,6,33,39,0.032,
8478469,20182019,Thomas Chabot,70,14,41,55,0.0757,
8478469,20172018,Thomas Chabot,63,9,16,25,0.0957,
8478469,20162017,Thomas Chabot,1,0,0,0,0.0,
8475324,20242025,Nick Jensen,71,3,18,21,0.038961,3.26
8475324,20232024,Nick Jensen,78,1,13,14,0.014085,3.48
8475324,20222023,Nick Jensen,77,5,24,29,0.045872,5.22
8475324,20212022,Nick Jensen,76,5,16,21,0.057,3.97
8475324,20202021,Nick Jensen,53,2,12,14,0.033,1.68
8475324,20192020,Nick Jensen,68,0,8,8,0.0,
8475324,20182019,Nick Jensen,20,0,5,5,0.0,
8475324,20172018,Nick Jensen,81,0,15,15,0.0,
8475324,20162017,Nick Jensen,49,4,9,13,0.0678,
8482245,20242025,Artem Zub,56,2,11,13,0.035088,2.93
8482245,20232024,Artem Zub,69,5,20,25,0.058824,5.23
8482245,20222023,Artem Zub,53,3,7,10,0.073171,2.4
8482245,20212022,Artem Zub,81,6,16,22,0.065,3.79
8482245,20202021,Artem Zub,47,3,11,14,0.077,1.71
8476461,20242025,Sean Couturier,79,15,30,45,0.096774,20.57
8476461,20232024,Sean Couturier,74,11,27,38,0.057292,17.81
8475235,20242025,Nicolas Deslauriers,31,2,1,3,0.08,3.59
8475235,20232024,Nicolas Deslauriers,60,1,3,4,0.020408,5.31
8475235,20222023,Nicolas Deslauriers,80,6,6,12,0.085714,6.95
8475235,20212022,Nicolas Deslauriers,20,3,0,3,0.167,9.9
8475235,20202021,Nicolas Deslauriers,49,5,5,10,0.077,6.78
8475235,20192020,Nicolas Deslauriers,59,7,6,13,0.109,
8475235,20182019,Nicolas Deslauriers,48,2,3,5,0.0417,
8475235,20172018,Nicolas Deslauriers,58,10,4,14,0.1299,
8475235,20162017,Nicolas Deslauriers,42,0,2,2,0.0,
8475235,20152016,Nicolas Deslauriers,70,6,6,12,0.0833,
8475235,20142015,Nicolas Deslauriers,82,5,10,15,0.0658,
8475235,20132014,Nicolas Deslauriers,17,1,0,1,0.0333,
8477989,20242025,Christian Dvorak,82,12,21,33,0.115385,15.97
8477989,20232024,Christian Dvorak,30,5,4,9,0.142857,4.12
8477989,20222023,Christian Dvorak,64,10,18,28,0.113636,12.31
8477989,20212022,Christian Dvorak,56,11,22,33,0.126,11.86
8477989,20202021,Christian Dvorak,56,17,14,31,0.179,15.22
8477989,20192020,Christian Dvorak,70,18,20,38,0.134,
8477989,20182019,Christian Dvorak,20,2,5,7,0.08,
8477989,20172018,Christian Dvorak,78,15,22,37,0.0993,
8477989,20162017,Christian Dvorak,78,15,18,33,0.1705,
8477903,20242025,Garnet Hathaway,67,10,11,21,0.125,8.72
8477903,20232024,Garnet Hathaway,82,7,10,17,0.067961,12.23
8477903,20222023,Garnet Hathaway,25,4,2,6,0.222222,11.58
8477903,20212022,Garnet Hathaway,76,14,12,26,0.113,14.44
8477903,20202021,Garnet Hathaway,56,6,12,18,0.097,7.66
8477903,20192020,Garnet Hathaway,66,9,7,16,0.113,
8477903,20182019,Garnet Hathaway,76,11,8,19,0.1429,
8477903,20172018,Garnet Hathaway,59,4,9,13,0.0588,
8477903,20162017,Garnet Hathaway,26,1,4,5,0.0455,
8477903,20152016,Garnet Hathaway,14,0,3,3,0.0,
8478439,20242025,Travis Konecny,82,24,52,76,0.12766,24.74
8478439,20232024,Travis Konecny,76,33,35,68,0.135246,26.25
8478439,20222023,Travis Konecny,60,31,30,61,0.162304,23.29
8478439,20212022,Travis Konecny,79,16,36,52,0.073,23.47
8478439,20202021,Travis Konecny,50,11,23,34,0.11,10.38
8478439,20192020,Travis Konecny,66,24,37,61,0.17,
8478439,20182019,Travis Konecny,82,24,25,49,0.1319,
8478439,20172018,Travis Konecny,81,24,23,47,0.1356,
8478439,20162017,Travis Konecny,70,11,17,28,0.0827,
8478409,20242025,Anthony Richard,15,2,4,6,0.105263,1.81
8478409,20232024,Anthony Richard,9,1,2,3,0.166667,0.93
8478409,20222023,Anthony Richard,13,3,2,5,0.230769,2.11
8480015,20242025,Owen Tippett,77,20,23,43,0.106383,15.91
8480015,20232024,Owen Tippett,78,28,25,53,0.096886,24.24
8480015,20222023,Owen Tippett,77,27,22,49,0.116883,24.25
8480015,20212022,Owen Tippett,21,4,3,7,0.075,13.76
8480015,20202021,Owen Tippett,45,7,11,18,0.081,8.76
8481533,20242025,Trevor Zegras,57,12,20,32,0.122449,11.63
8481533,20232024,Trevor Zegras,31,6,9,15,0.082192,7.33
8481533,20222023,Trevor Zegras,81,23,42,65,0.125,15.24
8481533,20212022,Trevor Zegras,75,23,38,61,0.127,16.67
8481533,20202021,Trevor Zegras,24,3,10,13,0.057,3.87
8482142,20242025,Jamie Drysdale,70,7,13,20,0.111111,3.58
8482142,20232024,Jamie Drysdale,24,2,3,5,0.058824,2.82
8482142,20222023,Jamie Drysdale,8,0,0,0,0.0,0.34
8482142,20212022,Jamie Drysdale,81,4,28,32,0.029,6.97
8482142,20202021,Jamie Drysdale,24,3,5,8,0.107,0.93
8478502,20242025,Dennis Gilbert,4,0,1,1,0.0,0.35
8478502,20232024,Dennis Gilbert,34,1,6,7,0.043478,0.89
8478502,20222023,Dennis Gilbert,23,1,3,4,0.076923,0.37
8478454,20242025,Noah Juulsen,35,0,0,0,0.0,0.93
8478454,20232024,Noah Juulsen,54,1,6,7,0.033333,1.34
8478454,20222023,Noah Juulsen,12,0,0,0,0.0,0.23
8478454,20212022,Noah Juulsen,8,0,2,2,0.0,0.14
8478454,20202021,Noah Juulsen,4,0,0,0,0.0,0.1
8477499,20242025,Rasmus Ristolainen,63,4,15,19,0.04,5.48
8477499,20232024,Rasmus Ristolainen,31,1,3,4,0.021739,2
8477499,20222023,Rasmus Ristolainen,74,3,17,20,0.034884,4.99
8477499,20212022,Rasmus Ristolainen,66,2,14,16,0.021,6.07
8477499,20202021,Rasmus Ristolainen,49,4,14,18,0.055,5.22
8477499,20192020,Rasmus Ristolainen,69,6,27,33,0.047,
8477499,20182019,Rasmus Ristolainen,78,5,38,43,0.0275,
8477499,20172018,Rasmus Ristolainen,73,6,35,41,0.033,
8477499,20162017,Rasmus Ristolainen,79,6,39,45,0.0323,
8477499,20152016,Rasmus Ristolainen,82,9,32,41,0.0446,
8477499,20142015,Rasmus Ristolainen,78,8,12,20,0.0661,
8477499,20132014,Rasmus Ristolainen,34,2,2,4,0.0385,
8477948,20242025,Travis Sanheim,82,8,22,30,0.057554,11.3
8477948,20232024,Travis Sanheim,81,10,34,44,0.068493,9.45
8477948,20222023,Travis Sanheim,81,7,16,23,0.063063,7.47
8477948,20212022,Travis Sanheim,80,7,24,31,0.057,7.04
8477948,20202021,Travis Sanheim,55,3,12,15,0.03,5.7
8477948,20192020,Travis Sanheim,69,8,17,25,0.073,
8477948,20182019,Travis Sanheim,82,9,26,35,0.0744,
8477948,20172018,Travis Sanheim,49,2,8,10,0.0278,
8476372,20242025,Nick Seeler,77,3,17,20,0.036585,4.03
8476372,20232024,Nick Seeler,71,1,12,13,0.01,3.36
8476372,20222023,Nick Seeler,77,4,10,14,0.047619,3.32
8476372,20212022,Nick Seeler,43,1,2,3,0.031,1.21
8481546,20242025,Cam York,66,4,13,17,0.061538,4.94
8481546,20232024,Cam York,82,10,20,30,0.074627,9.1
8481546,20222023,Cam York,54,2,18,20,0.047619,3.49
8481546,20212022,Cam York,30,3,7,10,0.091,1.27
8481546,20202021,Cam York,3,0,0,0,0.0,0.05
8481178,20242025,Egor Zamula,63,3,12,15,0.081081,1.52
8481178,20232024,Egor Zamula,66,5,16,21,0.081967,2.69
8481178,20222023,Egor Zamula,14,0,4,4,0.0,0.15
8481178,20212022,Egor Zamula,10,0,0,0,0.0,0.23
8481178,20202021,Egor Zamula,2,0,0,0,0.0,0.11
8478569,20242025,Noel Acciari,79,5,7,12,0.066667,11.18
8478569,20232024,Noel Acciari,55,4,3,7,0.067797,6.84
8478569,20222023,Noel Acciari,23,4,1,5,0.142857,17.13
8478569,20212022,Noel Acciari,20,3,5,8,0.094,4.73
8478569,20202021,Noel Acciari,41,4,7,11,0.059,7.97
8478569,20192020,Noel Acciari,66,20,7,27,0.185,
8478569,20182019,Noel Acciari,72,6,8,14,0.0606,
8478569,20172018,Noel Acciari,60,10,1,11,0.1515,
8478569,20162017,Noel Acciari,29,2,3,5,0.0833,
8478569,20152016,Noel Acciari,19,0,1,1,0.0,
8471675,20242025,Sidney Crosby,80,33,58,91,0.145374,30.2
8471675,20232024,Sidney Crosby,82,42,52,94,0.151079,40.47
8471675,20222023,Sidney Crosby,82,33,60,93,0.129412,33.31
8471675,20212022,Sidney Crosby,69,31,53,84,0.149,26.02
8471675,20202021,Sidney Crosby,55,24,38,62,0.151,20.07
8471675,20192020,Sidney Crosby,41,16,31,47,0.147,
8471675,20182019,Sidney Crosby,79,35,65,100,0.1591,
8471675,20172018,Sidney Crosby,82,29,60,89,0.1174,
8471675,20162017,Sidney Crosby,75,44,45,89,0.1725,
8471675,20152016,Sidney Crosby,80,36,49,85,0.1452,
8471675,20142015,Sidney Crosby,77,28,56,84,0.1181,
8471675,20132014,Sidney Crosby,80,36,68,104,0.139,
8471675,20122013,Sidney Crosby,36,15,41,56,0.121,
8471675,20112012,Sidney Crosby,22,8,29,37,0.1067,
8471675,20102011,Sidney Crosby,41,32,34,66,0.1988,
8471675,20092010,Sidney Crosby,81,51,58,109,0.1711,
8471675,20082009,Sidney Crosby,77,33,70,103,0.1387,
8471675,20072008,Sidney Crosby,53,24,48,72,0.1387,
8471675,20062007,Sidney Crosby,79,36,84,120,0.144,
8471675,20052006,Sidney Crosby,81,39,63,102,0.1403,
8475763,20242025,Kevin Hayes,64,13,10,23,0.132653,13.31
8475763,20232024,Kevin Hayes,79,13,16,29,0.084967,14.08
8475763,20222023,Kevin Hayes,81,18,36,54,0.086124,17.93
8475763,20212022,Kevin Hayes,48,10,21,31,0.079,9.34
8475763,20202021,Kevin Hayes,55,12,19,31,0.094,13.51
8475763,20192020,Kevin Hayes,69,23,18,41,0.131,
8475763,20182019,Kevin Hayes,20,5,8,13,0.1351,
8475763,20172018,Kevin Hayes,76,25,19,44,0.1453,
8475763,20162017,Kevin Hayes,76,17,32,49,0.1189,
8475763,20152016,Kevin Hayes,79,14,22,36,0.1053,
8475763,20142015,Kevin Hayes,79,17,28,45,0.1532,
8478046,20242025,Danton Heinen,28,3,8,11,0.081081,11.1
8478046,20232024,Danton Heinen,74,17,19,36,0.142857,16.23
8478046,20222023,Danton Heinen,65,8,14,22,0.083333,9.96
8478046,20212022,Danton Heinen,76,18,15,33,0.13,16.93
8478046,20202021,Danton Heinen,43,7,7,14,0.092,8.51
8478046,20192020,Danton Heinen,9,3,1,4,0.158,
8478046,20182019,Danton Heinen,77,11,23,34,0.0965,
8478046,20172018,Danton Heinen,77,16,31,47,0.1185,
8478046,20162017,Danton Heinen,8,0,0,0,0.0,
8481481,20242025,Blake Lizotte,59,11,9,20,0.215686,7.19
8481481,20232024,Blake Lizotte,62,7,8,15,0.092105,7.89
8481481,20222023,Blake Lizotte,81,11,23,34,0.101852,12.88
8481481,20212022,Blake Lizotte,70,10,14,24,0.11,9.7
8481481,20202021,Blake Lizotte,41,3,7,10,0.071,4.64
8481481,20192020,Blake Lizotte,65,6,17,23,0.069,
8481481,20182019,Blake Lizotte,1,0,0,0,0.0,
8471215,20242025,Evgeni Malkin,68,16,34,50,0.128,18.81
8471215,20232024,Evgeni Malkin,82,27,40,67,0.135678,25.18
8471215,20222023,Evgeni Malkin,82,27,56,83,0.1125,27.2
8471215,20212022,Evgeni Malkin,41,20,22,42,0.155,14.65
8471215,20202021,Evgeni Malkin,33,8,20,28,0.111,5.68
8471215,20192020,Evgeni Malkin,55,25,49,74,0.146,
8471215,20182019,Evgeni Malkin,68,21,51,72,0.1123,
8471215,20172018,Evgeni Malkin,78,42,56,98,0.1757,
8471215,20162017,Evgeni Malkin,62,33,39,72,0.1728,
8471215,20152016,Evgeni Malkin,57,27,31,58,0.1667,
8471215,20142015,Evgeni Malkin,69,28,42,70,0.1321,
8471215,20132014,Evgeni Malkin,60,23,49,72,0.1204,
8471215,20122013,Evgeni Malkin,31,9,24,33,0.0909,
8471215,20112012,Evgeni Malkin,75,50,59,109,0.1475,
8471215,20102011,Evgeni Malkin,43,15,22,37,0.0824,
8471215,20092010,Evgeni Malkin,67,28,49,77,0.1045,
8471215,20082009,Evgeni Malkin,82,35,78,113,0.1207,
8471215,20072008,Evgeni Malkin,82,47,59,106,0.1728,
8471215,20062007,Evgeni Malkin,78,33,52,85,0.1364,
8477511,20242025,Anthony Mantha,13,4,3,7,0.266667,2
8477511,20232024,Anthony Mantha,18,3,7,10,0.130435,13.92
8477511,20222023,Anthony Mantha,67,11,16,27,0.092437,13.28
8477511,20212022,Anthony Mantha,37,9,14,23,0.11,9.18
8477511,20202021,Anthony Mantha,14,4,4,8,0.105,11.26
8477511,20192020,Anthony Mantha,43,16,22,38,0.117,
8477511,20182019,Anthony Mantha,67,25,23,48,0.1263,
8477511,20172018,Anthony Mantha,80,24,24,48,0.1263,
8477511,20162017,Anthony Mantha,60,17,19,36,0.1278,
8477511,20152016,Anthony Mantha,10,2,1,3,0.1111,
8476483,20242025,Rickard Rakell,81,35,35,70,0.172414,31.72
8476483,20232024,Rickard Rakell,70,15,22,37,0.090909,19.5
8476483,20222023,Rickard Rakell,82,28,32,60,0.115226,33.01
8476483,20212022,Rickard Rakell,19,4,9,13,0.083,17.81
8476483,20202021,Rickard Rakell,52,9,19,28,0.063,14.89
8476483,20192020,Rickard Rakell,65,15,27,42,0.081,
8476483,20182019,Rickard Rakell,69,18,25,43,0.0928,
8476483,20172018,Rickard Rakell,77,34,35,69,0.1478,
8476483,20162017,Rickard Rakell,71,33,18,51,0.1864,
8476483,20152016,Rickard Rakell,72,20,23,43,0.1183,
8476483,20142015,Rickard Rakell,71,9,22,31,0.0857,
8476483,20132014,Rickard Rakell,18,0,4,4,0.0,
8476483,20122013,Rickard Rakell,4,0,0,0,0.0,
8475810,20242025,Bryan Rust,71,31,34,65,0.162304,27.94
8475810,20232024,Bryan Rust,62,28,28,56,0.142857,24.25
8475810,20222023,Bryan Rust,81,20,26,46,0.094787,27.18
8475810,20212022,Bryan Rust,60,24,34,58,0.133,25.45
8475810,20202021,Bryan Rust,56,22,20,42,0.143,20.85
8475810,20192020,Bryan Rust,55,27,29,56,0.179,
8475810,20182019,Bryan Rust,72,18,17,35,0.1277,
8475810,20172018,Bryan Rust,69,13,25,38,0.1057,
8475810,20162017,Bryan Rust,57,15,13,28,0.1364,
8475810,20152016,Bryan Rust,41,4,7,11,0.0588,
8475810,20142015,Bryan Rust,14,1,1,2,0.0294,
8477365,20242025,Connor Clifton,73,1,15,16,0.015873,3.32
8477365,20232024,Connor Clifton,79,4,14,18,0.051948,4.19
8477365,20222023,Connor Clifton,78,5,18,23,0.053763,5.42
8477365,20212022,Connor Clifton,60,2,8,10,0.025,2.43
8477365,20202021,Connor Clifton,44,1,6,7,0.021,1.59
8477365,20192020,Connor Clifton,31,2,0,2,0.1,
8477365,20182019,Connor Clifton,19,0,1,1,0.0,
8476856,20242025,Mathew Dumba,63,1,9,10,0.017544,3.38
8476856,20232024,Mathew Dumba,18,0,2,2,0.0,5.32
8476856,20222023,Mathew Dumba,79,4,10,14,0.040404,6.44
8476856,20212022,Mathew Dumba,57,7,20,27,0.06,6.83
8476856,20202021,Mathew Dumba,51,6,15,21,0.067,5.67
8476856,20192020,Mathew Dumba,69,6,18,24,0.036,
8476856,20182019,Mathew Dumba,32,12,10,22,0.129,
8476856,20172018,Mathew Dumba,82,14,36,50,0.0795,
8476856,20162017,Mathew Dumba,76,11,23,34,0.084,
8476856,20152016,Mathew Dumba,81,10,16,26,0.0658,
8476856,20142015,Mathew Dumba,58,8,8,16,0.093,
8476856,20132014,Mathew Dumba,13,1,1,2,0.0833,
8477435,20242025,Ryan Graves,61,1,3,4,0.025641,1.39
8477435,20232024,Ryan Graves,70,3,11,14,0.038961,2.59
8477435,20222023,Ryan Graves,78,8,18,26,0.056738,5.71
8477435,20212022,Ryan Graves,75,6,22,28,0.054,5.25
8477435,20202021,Ryan Graves,54,2,13,15,0.02,3.82
8477435,20192020,Ryan Graves,69,9,17,26,0.067,
8477435,20182019,Ryan Graves,26,3,2,5,0.1154,
8478452,20242025,Caleb Jones,6,0,0,0,0.0,0.1
8478452,20232024,Caleb Jones,25,0,5,5,0.0,1.14
8478452,20222023,Caleb Jones,73,4,12,16,0.046512,6.5
8478452,20212022,Caleb Jones,51,5,10,15,0.088,3.99
8478452,20202021,Caleb Jones,33,0,4,4,0.0,0.81
8478452,20192020,Caleb Jones,43,4,5,9,0.105,
8478452,20182019,Caleb Jones,17,1,5,6,0.0476,
8474578,20242025,Erik Karlsson,82,11,42,53,0.057592,9.13
8474578,20232024,Erik Karlsson,82,11,45,56,0.051643,10.44
8474578,20222023,Erik Karlsson,82,25,76,101,0.119617,12.42
8474578,20212022,Erik Karlsson,50,10,25,35,0.085,5.58
8474578,20202021,Erik Karlsson,52,8,14,22,0.073,5.3
8474578,20192020,Erik Karlsson,56,6,34,40,0.05,
8474578,20182019,Erik Karlsson,53,3,42,45,0.0178,
8474578,20172018,Erik Karlsson,71,9,53,62,0.0459,
8474578,20162017,Erik Karlsson,77,17,54,71,0.078,
8474578,20152016,Erik Karlsson,82,16,66,82,0.0645,
8474578,20142015,Erik Karlsson,82,21,45,66,0.0719,
8474578,20132014,Erik Karlsson,82,20,54,74,0.0778,
8474578,20122013,Erik Karlsson,17,6,8,14,0.0759,
8474578,20112012,Erik Karlsson,81,19,59,78,0.0728,
8474578,20102011,Erik Karlsson,75,13,32,45,0.0714,
8474578,20092010,Erik Karlsson,60,5,21,26,0.0446,
8471724,20242025,Kris Letang,74,9,21,30,0.054878,9.1
8471724,20232024,Kris Letang,82,10,41,51,0.060976,7.82
8471724,20222023,Kris Letang,64,12,29,41,0.074534,9
8471724,20212022,Kris Letang,78,10,58,68,0.047,9.69
8471724,20202021,Kris Letang,55,7,38,45,0.053,4.76
8471724,20192020,Kris Letang,61,15,29,44,0.085,
8471724,20182019,Kris Letang,65,16,40,56,0.0777,
8471724,20172018,Kris Letang,79,9,42,51,0.0405,
8471724,20162017,Kris Letang,41,5,29,34,0.041,
8471724,20152016,Kris Letang,71,16,51,67,0.0734,
8471724,20142015,Kris Letang,69,11,43,54,0.0558,
8471724,20132014,Kris Letang,37,11,11,22,0.1019,
8471724,20122013,Kris Letang,35,5,33,38,0.0526,
8471724,20112012,Kris Letang,51,10,32,42,0.0704,
8471724,20102011,Kris Letang,82,8,42,50,0.0339,
8471724,20092010,Kris Letang,73,3,24,27,0.0172,
8471724,20082009,Kris Letang,74,10,23,33,0.0725,
8471724,20072008,Kris Letang,63,6,11,17,0.0882,
8471724,20062007,Kris Letang,7,2,0,2,0.25,
8474586,20242025,Jordan Eberle,42,9,17,26,0.136364,9.56
8474586,20232024,Jordan Eberle,78,17,27,44,0.10119,22.4
8474586,20222023,Jordan Eberle,82,20,43,63,0.112994,18.68
8474586,20212022,Jordan Eberle,79,21,23,44,0.128,20.41
8474586,20202021,Jordan Eberle,55,16,17,33,0.125,13.59
8474586,20192020,Jordan Eberle,58,16,24,40,0.118,
8474586,20182019,Jordan Eberle,78,19,18,37,0.1188,
8474586,20172018,Jordan Eberle,81,25,34,59,0.1366,
8474586,20162017,Jordan Eberle,82,20,31,51,0.0962,
8474586,20152016,Jordan Eberle,69,25,22,47,0.1445,
8474586,20142015,Jordan Eberle,81,24,39,63,0.1311,
8474586,20132014,Jordan Eberle,80,28,37,65,0.14,
8474586,20122013,Jordan Eberle,48,16,21,37,0.1203,
8474586,20112012,Jordan Eberle,78,34,42,76,0.1889,
8474586,20102011,Jordan Eberle,69,18,25,43,0.1139,
8477919,20242025,Frederick Gaudreau,82,18,19,37,0.163636,10.88
8477919,20232024,Frederick Gaudreau,67,5,10,15,0.047619,6.44
8477919,20222023,Frederick Gaudreau,82,19,19,38,0.137681,14.91
8477919,20212022,Frederick Gaudreau,76,14,30,44,0.106,12.23
8477919,20202021,Frederick Gaudreau,19,2,8,10,0.1,2.27
8477401,20242025,John Hayden,20,1,1,2,0.05,3.05
8477401,20232024,John Hayden,2,0,0,0,0.0,0.02
8477401,20222023,John Hayden,7,2,0,2,0.222222,0.97
8477401,20212022,John Hayden,55,2,2,4,0.031,5.36
8477401,20202021,John Hayden,29,2,3,5,0.095,1.48
8477401,20192020,John Hayden,43,3,1,4,0.077,
8477401,20182019,John Hayden,54,3,2,5,0.0714,
8477401,20172018,John Hayden,47,4,9,13,0.0714,
8477401,20162017,John Hayden,12,1,3,4,0.0455,
8481554,20242025,Kaapo Kakko,49,10,20,30,0.138889,15.78
8481554,20232024,Kaapo Kakko,61,13,6,19,0.142857,7.89
8481554,20222023,Kaapo Kakko,82,18,22,40,0.144,16.21
8481554,20212022,Kaapo Kakko,43,7,11,18,0.113,8.45
8481554,20202021,Kaapo Kakko,48,9,8,17,0.111,8.76
8481554,20192020,Kaapo Kakko,66,10,13,23,0.092,
8478975,20242025,Mason Marchment,62,22,25,47,0.164179,19.18
8478975,20232024,Mason Marchment,81,22,31,53,0.146667,20.18
8478975,20222023,Mason Marchment,68,12,19,31,0.081081,18.81
8478975,20212022,Mason Marchment,54,18,29,47,0.149,18.11
8478975,20202021,Mason Marchment,33,2,8,10,0.04,4.91
8478975,20192020,Mason Marchment,4,0,1,1,0.0,
8477955,20242025,Jared McCann,82,22,39,61,0.108911,22.73
8477955,20232024,Jared McCann,80,29,33,62,0.134259,20.98
8477955,20222023,Jared McCann,79,40,30,70,0.190476,20.36
8477955,20212022,Jared McCann,74,27,23,50,0.136,21.8
8477955,20202021,Jared McCann,43,14,18,32,0.151,10.37
8477955,20192020,Jared McCann,66,14,21,35,0.093,
8477955,20182019,Jared McCann,32,11,6,17,0.1528,
8477955,20172018,Jared McCann,68,9,19,28,0.0629,
8477955,20162017,Jared McCann,29,1,6,7,0.0227,
8477955,20152016,Jared McCann,69,9,9,18,0.0849,
8475768,20242025,Jaden Schwartz,81,26,23,49,0.134021,30.07
8475768,20232024,Jaden Schwartz,62,13,17,30,0.111111,17.36
8475768,20222023,Jaden Schwartz,71,21,19,40,0.125749,25.23
8475768,20212022,Jaden Schwartz,37,8,15,23,0.079,8.92
8475768,20202021,Jaden Schwartz,40,8,13,21,0.113,6.29
8475768,20192020,Jaden Schwartz,71,22,35,57,0.136,
8475768,20182019,Jaden Schwartz,69,11,25,36,0.0601,
8475768,20172018,Jaden Schwartz,62,24,35,59,0.1529,
8475768,20162017,Jaden Schwartz,78,19,36,55,0.1061,
8475768,20152016,Jaden Schwartz,33,8,14,22,0.127,
8475768,20142015,Jaden Schwartz,75,28,35,63,0.1522,
8475768,20132014,Jaden Schwartz,80,25,31,56,0.133,
8475768,20122013,Jaden Schwartz,45,7,6,13,0.14,
8475768,20112012,Jaden Schwartz,7,2,1,3,0.3333,
8476905,20242025,Chandler Stephenson,78,13,38,51,0.178082,8.49
8476905,20232024,Chandler Stephenson,75,16,35,51,0.164948,10.9
8476905,20222023,Chandler Stephenson,81,16,49,65,0.133333,19
8476905,20212022,Chandler Stephenson,79,21,43,64,0.168,18.07
8476905,20202021,Chandler Stephenson,51,14,21,35,0.169,10.04
8476905,20192020,Chandler Stephenson,41,8,14,22,0.145,
8476905,20182019,Chandler Stephenson,64,5,6,11,0.1389,
8476905,20172018,Chandler Stephenson,67,6,12,18,0.1667,
8476905,20162017,Chandler Stephenson,4,0,0,0,0.0,
8476905,20152016,Chandler Stephenson,9,0,0,0,0.0,
8480009,20242025,Eeli Tolvanen,81,23,12,35,0.167883,16.07
8480009,20232024,Eeli Tolvanen,81,16,25,41,0.104575,16.55
8480009,20222023,Eeli Tolvanen,48,16,11,27,0.164948,11.37
8480009,20212022,Eeli Tolvanen,75,11,12,23,0.073,13.98
8480009,20202021,Eeli Tolvanen,40,11,11,22,0.169,5.33
8478407,20242025,Vince Dunn,62,11,28,39,0.080292,7.09
8478407,20232024,Vince Dunn,59,11,35,46,0.091667,6.65
8478407,20222023,Vince Dunn,81,14,50,64,0.09396,9.75
8478407,20212022,Vince Dunn,73,7,28,35,0.058,6.52
8478407,20202021,Vince Dunn,43,6,14,20,0.082,3.46
8478407,20192020,Vince Dunn,71,9,14,23,0.065,
8478407,20182019,Vince Dunn,78,12,23,35,0.08,
8478407,20172018,Vince Dunn,75,5,19,24,0.0362,
8479985,20242025,Cale Fleury,14,0,1,1,0.0,0.61
8479985,20232024,Cale Fleury,1,0,0,0,0.0,0.02
8479985,20222023,Cale Fleury,12,0,1,1,0.0,0.72
8479985,20212022,Cale Fleury,9,0,0,0,0.0,0.03
8476457,20242025,Adam Larsson,82,7,21,28,0.0625,6.58
8476457,20232024,Adam Larsson,81,4,14,18,0.030769,6.82
8476457,20222023,Adam Larsson,82,8,25,33,0.055944,6.94
8476457,20212022,Adam Larsson,82,8,17,25,0.067,4.5
8476457,20202021,Adam Larsson,56,4,6,10,0.077,2.69
8476457,20192020,Adam Larsson,49,1,5,6,0.016,
8476457,20182019,Adam Larsson,82,3,17,20,0.0256,
8476457,20172018,Adam Larsson,63,4,9,13,0.0435,
8476457,20162017,Adam Larsson,79,4,15,19,0.0471,
8476457,20152016,Adam Larsson,82,3,15,18,0.0462,
8476457,20142015,Adam Larsson,64,3,21,24,0.033,
8476457,20132014,Adam Larsson,26,1,2,3,0.05,
8476457,20122013,Adam Larsson,37,0,6,6,0.0,
8476457,20112012,Adam Larsson,65,2,16,18,0.0294,
8479324,20242025,Ryan Lindgren,18,2,1,3,0.095238,3.72
8479324,20232024,Ryan Lindgren,76,3,14,17,0.041096,3.27
8479324,20222023,Ryan Lindgren,63,1,17,18,0.013333,3.81
8479324,20212022,Ryan Lindgren,78,4,11,15,0.055,4.05
8479324,20202021,Ryan Lindgren,51,1,15,16,0.015,2.77
8479324,20192020,Ryan Lindgren,60,1,13,14,0.021,
8479324,20182019,Ryan Lindgren,5,0,0,0,0.0,
8479372,20242025,Joshua Mahura,64,0,9,9,0.0,2.62
8479372,20232024,Joshua Mahura,30,0,9,9,0.0,0.95
8479372,20222023,Joshua Mahura,82,4,12,16,0.051282,3.7
8479372,20212022,Joshua Mahura,38,3,4,7,0.083,1.5
8479372,20202021,Joshua Mahura,13,1,3,4,0.071,0.38
8479372,20192020,Joshua Mahura,11,1,3,4,0.091,
8479372,20182019,Joshua Mahura,17,1,4,5,0.05,
8477986,20242025,Brandon Montour,81,18,23,41,0.077922,15.79
8477986,20232024,Brandon Montour,66,8,25,33,0.047619,9.97
8477986,20222023,Brandon Montour,80,16,57,73,0.066116,16.92
8477986,20212022,Brandon Montour,81,11,26,37,0.072,10.17
8477986,20202021,Brandon Montour,12,2,2,4,0.091,5.22
8477986,20192020,Brandon Montour,54,5,13,18,0.058,
8477986,20182019,Brandon Montour,20,3,7,10,0.0545,
8477986,20172018,Brandon Montour,80,9,23,32,0.0563,
8477986,20162017,Brandon Montour,27,2,4,6,0.04,
8476467,20242025,Jamie Oleksiak,82,4,13,17,0.060606,3.87
8476467,20232024,Jamie Oleksiak,82,2,13,15,0.018519,5.27
8476467,20222023,Jamie Oleksiak,75,9,16,25,0.118421,3.76
8476467,20212022,Jamie Oleksiak,72,1,16,17,0.011,5.96
8476467,20202021,Jamie Oleksiak,56,6,8,14,0.071,4.37
8476467,20192020,Jamie Oleksiak,69,3,7,10,0.039,
8476467,20182019,Jamie Oleksiak,21,0,1,1,0.0,
8476467,20172018,Jamie Oleksiak,47,4,10,14,0.0625,
8476467,20162017,Jamie Oleksiak,41,5,2,7,0.1515,
8476467,20152016,Jamie Oleksiak,19,0,2,2,0.0,
8476467,20142015,Jamie Oleksiak,36,1,7,8,0.0278,
8476467,20132014,Jamie Oleksiak,7,0,0,0,0.0,
8476467,20122013,Jamie Oleksiak,16,0,2,2,0.0,
8480848,20242025,Ty Dellandrea,68,1,7,8,0.02,7.66
8480848,20232024,Ty Dellandrea,42,2,7,9,0.037736,5.55
8480848,20222023,Ty Dellandrea,82,9,19,28,0.097826,10.38
8480848,20212022,Ty Dellandrea,1,0,0,0,0.0,0.02
8480848,20202021,Ty Dellandrea,26,3,2,5,0.097,3.24
8478874,20242025,Adam Gaudette,81,19,7,26,0.211111,11.85
8478874,20232024,Adam Gaudette,2,0,0,0,0.0,0.06
8476624,20242025,Barclay Goodrow,77,5,3,8,0.068493,8.9
8476624,20232024,Barclay Goodrow,80,4,8,12,0.065574,8.41
8476624,20222023,Barclay Goodrow,82,11,20,31,0.123596,10.72
8476624,20212022,Barclay Goodrow,79,13,20,33,0.112,15.93
8476624,20202021,Barclay Goodrow,55,6,14,20,0.083,8.97
8476624,20192020,Barclay Goodrow,8,0,2,2,0.0,
8476624,20182019,Barclay Goodrow,82,7,10,17,0.0833,
8476624,20172018,Barclay Goodrow,47,7,7,14,0.1228,
8476624,20162017,Barclay Goodrow,3,0,1,1,0.0,
8476624,20152016,Barclay Goodrow,14,0,3,3,0.0,
8476624,20142015,Barclay Goodrow,60,4,8,12,0.0588,
8479336,20242025,Carl Grundstrom,56,3,6,9,0.034091,7.5
8479336,20232024,Carl Grundstrom,50,8,4,12,0.084211,9.51
8479336,20222023,Carl Grundstrom,57,12,7,19,0.133333,9.63
8479336,20212022,Carl Grundstrom,54,9,6,15,0.108,8.8
8479336,20202021,Carl Grundstrom,47,6,5,11,0.091,4.69
8479336,20192020,Carl Grundstrom,13,0,4,4,0.0,
8479336,20182019,Carl Grundstrom,15,5,1,6,0.1923,
8480798,20242025,Philipp Kurashev,51,7,7,14,0.12963,6.4
8480798,20232024,Philipp Kurashev,75,18,36,54,0.140625,17.04
8480798,20222023,Philipp Kurashev,70,9,16,25,0.077586,11.26
8480798,20212022,Philipp Kurashev,67,6,15,21,0.07,7.36
8480798,20202021,Philipp Kurashev,54,8,8,16,0.123,7.05
8471817,20242025,Ryan Reaves,35,0,2,2,0.0,1.51
8471817,20232024,Ryan Reaves,49,4,2,6,0.153846,3.91
8471817,20222023,Ryan Reaves,61,5,10,15,0.111111,6.7
8471817,20212022,Ryan Reaves,69,5,8,13,0.114,4.66
8471817,20202021,Ryan Reaves,37,1,4,5,0.038,3.83
8471817,20192020,Ryan Reaves,71,8,7,15,0.131,
8471817,20182019,Ryan Reaves,80,9,11,20,0.0947,
8471817,20172018,Ryan Reaves,21,0,2,2,0.0,
8471817,20162017,Ryan Reaves,80,7,6,13,0.1207,
8471817,20152016,Ryan Reaves,64,3,1,4,0.0968,
8471817,20142015,Ryan Reaves,81,6,6,12,0.1091,
8471817,20132014,Ryan Reaves,63,2,6,8,0.08,
8471817,20122013,Ryan Reaves,43,4,2,6,0.1667,
8471817,20112012,Ryan Reaves,60,3,1,4,0.0938,
8471817,20102011,Ryan Reaves,28,2,2,4,0.125,
8475784,20242025,Jeff Skinner,72,16,13,29,0.111111,16.15
8475784,20232024,Jeff Skinner,74,24,22,46,0.113744,22.77
8475784,20222023,Jeff Skinner,79,35,47,82,0.144628,30.53
8475784,20212022,Jeff Skinner,80,33,30,63,0.126,29.39
8475784,20202021,Jeff Skinner,53,7,7,14,0.063,10.7
8475784,20192020,Jeff Skinner,59,14,9,23,0.077,
8475784,20182019,Jeff Skinner,82,40,23,63,0.1493,
8475784,20172018,Jeff Skinner,82,24,25,49,0.0866,
8475784,20162017,Jeff Skinner,79,37,26,63,0.1317,
8475784,20152016,Jeff Skinner,82,28,23,51,0.1085,
8475784,20142015,Jeff Skinner,77,18,13,31,0.0766,
8475784,20132014,Jeff Skinner,71,33,21,54,0.1204,
8475784,20122013,Jeff Skinner,42,13,11,24,0.0818,
8475784,20112012,Jeff Skinner,64,20,24,44,0.0952,
8475784,20102011,Jeff Skinner,82,31,32,63,0.1442,
8475726,20242025,Tyler Toffoli,78,30,24,54,0.128755,27.36
8475726,20232024,Tyler Toffoli,18,7,4,11,0.14,29.35
8475726,20222023,Tyler Toffoli,82,34,39,73,0.126866,29.78
8475726,20212022,Tyler Toffoli,37,11,12,23,0.116,20.81
8475726,20202021,Tyler Toffoli,52,28,16,44,0.177,21.89
8475726,20192020,Tyler Toffoli,10,6,4,10,0.158,
8475726,20182019,Tyler Toffoli,82,13,21,34,0.0575,
8475726,20172018,Tyler Toffoli,82,24,23,47,0.0956,
8475726,20162017,Tyler Toffoli,63,16,18,34,0.097,
8475726,20152016,Tyler Toffoli,82,31,27,58,0.1455,
8475726,20142015,Tyler Toffoli,76,23,26,49,0.115,
8475726,20132014,Tyler Toffoli,62,12,17,29,0.0968,
8475726,20122013,Tyler Toffoli,10,2,3,5,0.1,
8477505,20242025,Alexander Wennberg,77,10,25,35,0.121951,12.73
8477505,20232024,Alexander Wennberg,19,1,4,5,0.1,12.36
8477505,20222023,Alexander Wennberg,82,13,25,38,0.128713,16.8
8477505,20212022,Alexander Wennberg,80,11,26,37,0.116,9.41
8477505,20202021,Alexander Wennberg,56,17,12,29,0.207,11.03
8477505,20192020,Alexander Wennberg,57,5,17,22,0.069,
8477505,20182019,Alexander Wennberg,75,2,23,25,0.0313,
8477505,20172018,Alexander Wennberg,66,8,27,35,0.1081,
8477505,20162017,Alexander Wennberg,80,13,46,59,0.1193,
8477505,20152016,Alexander Wennberg,69,8,32,40,0.0825,
8477505,20142015,Alexander Wennberg,68,4,16,20,0.0471,
8478400,20242025,Colin White,3,0,0,0,0.0,0.41
8478400,20232024,Colin White,17,0,0,0,0.0,2.13
8478400,20222023,Colin White,68,8,7,15,0.125,6.64
8478400,20212022,Colin White,24,3,7,10,0.064,5.96
8478400,20202021,Colin White,45,10,8,18,0.145,9.29
8478400,20192020,Colin White,61,7,16,23,0.084,
8478400,20182019,Colin White,71,14,27,41,0.1138,
8478400,20172018,Colin White,21,2,4,6,0.0833,
8478400,20162017,Colin White,2,0,0,0,0.0,
8479523,20242025,Lucas Carlsson,13,1,3,4,0.066667,0.8
8479983,20242025,Mario Ferraro,78,5,12,17,0.063291,4.28
8479983,20232024,Mario Ferraro,78,3,18,21,0.024194,5.44
8479983,20222023,Mario Ferraro,72,4,7,11,0.060606,5.93
8479983,20212022,Mario Ferraro,63,2,12,14,0.041,2.32
8479983,20202021,Mario Ferraro,56,1,16,17,0.017,2.32
8479983,20192020,Mario Ferraro,61,2,9,11,0.032,
8475906,20242025,John Klingberg,11,1,3,4,0.052632,0.88
8475906,20232024,John Klingberg,14,0,5,5,0.0,0.96
8475906,20222023,John Klingberg,17,2,7,9,0.058824,6.1
8475906,20212022,John Klingberg,74,6,41,47,0.043,6.98
8475906,20202021,John Klingberg,53,7,29,36,0.065,4.87
8475906,20192020,John Klingberg,58,6,26,32,0.05,
8475906,20182019,John Klingberg,64,10,35,45,0.0654,
8475906,20172018,John Klingberg,82,8,59,67,0.0392,
8475906,20162017,John Klingberg,80,13,36,49,0.1048,
8475906,20152016,John Klingberg,76,10,48,58,0.0585,
8475906,20142015,John Klingberg,65,11,29,40,0.1122,
8475181,20242025,Nick Leddy,31,2,3,5,0.095238,0.65
8475181,20232024,Nick Leddy,82,3,25,28,0.036585,3.64
8475181,20222023,Nick Leddy,78,2,21,23,0.025316,4.2
8475181,20212022,Nick Leddy,20,2,6,8,0.105,2.71
8475181,20202021,Nick Leddy,56,2,29,31,0.025,3.59
8475181,20192020,Nick Leddy,60,3,18,21,0.042,
8475181,20182019,Nick Leddy,82,4,22,26,0.0345,
8475181,20172018,Nick Leddy,80,10,32,42,0.0654,
8475181,20162017,Nick Leddy,81,11,35,46,0.0803,
8475181,20152016,Nick Leddy,81,5,35,40,0.0413,
8475181,20142015,Nick Leddy,78,10,27,37,0.0833,
8475181,20132014,Nick Leddy,82,7,24,31,0.0569,
8475181,20122013,Nick Leddy,48,6,12,18,0.0923,
8475181,20112012,Nick Leddy,82,3,34,37,0.0319,
8475181,20102011,Nick Leddy,46,4,3,7,0.1081,
8480043,20242025,Timothy Liljegren,67,6,11,17,0.058824,4.85
8480043,20232024,Timothy Liljegren,55,3,20,23,0.048387,3.26
8480043,20222023,Timothy Liljegren,67,6,12,18,0.071429,4.26
8480043,20212022,Timothy Liljegren,61,5,18,23,0.063,3.65
8480043,20202021,Timothy Liljegren,2,0,0,0,0.0,0.07
8480043,20192020,Timothy Liljegren,11,0,1,1,0.0,
8475200,20242025,Dmitry Orlov,76,6,22,28,0.051282,6.7
8475200,20232024,Dmitry Orlov,82,6,20,26,0.046512,6.02
8475200,20222023,Dmitry Orlov,23,4,13,17,0.085106,6.77
8475200,20212022,Dmitry Orlov,76,12,23,35,0.094,7.39
8475200,20202021,Dmitry Orlov,51,8,14,22,0.096,4.1
8475200,20192020,Dmitry Orlov,69,4,23,27,0.038,
8475200,20182019,Dmitry Orlov,82,3,26,29,0.0297,
8475200,20172018,Dmitry Orlov,82,10,21,31,0.08,
8475200,20162017,Dmitry Orlov,82,6,27,33,0.048,
8475200,20152016,Dmitry Orlov,82,8,21,29,0.0889,
8475760,20242025,Nick Bjugstad,66,8,11,19,0.069565,12.02
8475760,20232024,Nick Bjugstad,76,22,23,45,0.133333,20.73
8475760,20222023,Nick Bjugstad,19,4,2,6,0.117647,19.12
8475760,20212022,Nick Bjugstad,57,7,6,13,0.086,10.12
8475760,20202021,Nick Bjugstad,44,6,11,17,0.077,7.71
8475760,20192020,Nick Bjugstad,13,1,1,2,0.056,
8475760,20182019,Nick Bjugstad,32,9,5,14,0.0957,
8475760,20172018,Nick Bjugstad,82,19,30,49,0.0826,
8475760,20162017,Nick Bjugstad,54,7,7,14,0.0769,
8475760,20152016,Nick Bjugstad,67,15,19,34,0.0877,
8475760,20142015,Nick Bjugstad,72,24,19,43,0.1159,
8475760,20132014,Nick Bjugstad,76,16,22,38,0.0865,
8475760,20122013,Nick Bjugstad,11,1,0,1,0.0588,
8477402,20242025,Pavel Buchnevich,76,20,37,57,0.137931,21.31
8477402,20232024,Pavel Buchnevich,80,27,36,63,0.130435,27.91
8477402,20222023,Pavel Buchnevich,63,26,41,67,0.211382,16.3
8477402,20212022,Pavel Buchnevich,73,30,46,76,0.151,22.29
8477402,20202021,Pavel Buchnevich,54,20,28,48,0.167,12.44
8477402,20192020,Pavel Buchnevich,68,16,30,46,0.108,
8477402,20182019,Pavel Buchnevich,64,21,17,38,0.1765,
8477402,20172018,Pavel Buchnevich,74,14,29,43,0.1029,
8477402,20162017,Pavel Buchnevich,41,8,12,20,0.1455,
8478472,20242025,Mathieu Joseph,60,4,10,14,0.057971,7.79
8478472,20232024,Mathieu Joseph,72,11,24,35,0.08871,15.06
8478472,20222023,Mathieu Joseph,56,3,15,18,0.045455,9.47
8478472,20212022,Mathieu Joseph,11,4,8,12,0.211,11.36
8478472,20202021,Mathieu Joseph,56,12,7,19,0.203,7.02
8478472,20192020,Mathieu Joseph,37,4,3,7,0.114,
8478472,20182019,Mathieu Joseph,70,13,13,26,0.1368,
8479385,20242025,Jordan Kyrou,82,36,34,70,0.150628,25.44
8479385,20232024,Jordan Kyrou,82,31,36,67,0.123506,24.72
8479385,20222023,Jordan Kyrou,79,37,36,73,0.136029,25.9
8479385,20212022,Jordan Kyrou,74,27,48,75,0.144,17.13
8479385,20202021,Jordan Kyrou,55,14,21,35,0.143,10.86
8479385,20192020,Jordan Kyrou,28,4,5,9,0.103,
8479385,20182019,Jordan Kyrou,16,1,2,3,0.0625,
8475170,20242025,Brayden Schenn,82,18,32,50,0.124138,22.33
8475170,20232024,Brayden Schenn,82,20,26,46,0.117647,24.78
8475170,20222023,Brayden Schenn,82,21,44,65,0.145833,19.64
8475170,20212022,Brayden Schenn,62,24,34,58,0.216,17.92
8475170,20202021,Brayden Schenn,56,16,20,36,0.142,15.76
8475170,20192020,Brayden Schenn,71,25,33,58,0.181,
8475170,20182019,Brayden Schenn,72,17,37,54,0.1069,
8475170,20172018,Brayden Schenn,82,28,42,70,0.1333,
8475170,20162017,Brayden Schenn,79,25,30,55,0.1404,
8475170,20152016,Brayden Schenn,80,26,33,59,0.1461,
8475170,20142015,Brayden Schenn,82,18,29,47,0.1154,
8475170,20132014,Brayden Schenn,82,20,21,41,0.1124,
8475170,20122013,Brayden Schenn,47,8,18,26,0.1013,
8475170,20112012,Brayden Schenn,54,12,6,18,0.1237,
8475170,20102011,Brayden Schenn,8,0,2,2,0.0,
8475170,20092010,Brayden Schenn,1,0,0,0,0.0,
8476897,20242025,Oskar Sundqvist,67,6,14,20,0.1,7.77
8476897,20232024,Oskar Sundqvist,71,6,15,21,0.088235,10.41
8476897,20222023,Oskar Sundqvist,15,3,4,7,0.3,10.52
8476897,20212022,Oskar Sundqvist,18,4,4,8,0.2,7.84
8476897,20202021,Oskar Sundqvist,28,4,5,9,0.125,4.25
8476897,20192020,Oskar Sundqvist,57,12,11,23,0.124,
8476897,20182019,Oskar Sundqvist,74,14,17,31,0.1239,
8476897,20172018,Oskar Sundqvist,42,1,4,5,0.0244,
8476897,20162017,Oskar Sundqvist,10,0,0,0,0.0,
8476897,20152016,Oskar Sundqvist,18,1,3,4,0.0769,
8480459,20242025,Pius Suter,81,25,21,46,0.181159,19.84
8480459,20232024,Pius Suter,67,14,15,29,0.133333,15.91
8480459,20222023,Pius Suter,79,14,10,24,0.132075,12.91
8480459,20212022,Pius Suter,82,15,21,36,0.09,21.66
8480459,20202021,Pius Suter,55,14,13,27,0.125,13.86
8480074,20242025,Alexandre Texier,31,6,5,11,0.12,3.79
8480074,20232024,Alexandre Texier,78,12,18,30,0.110092,10.93
8480023,20242025,Robert Thomas,70,21,60,81,0.144828,16.88
8480023,20232024,Robert Thomas,82,26,60,86,0.152941,22.59
8480023,20222023,Robert Thomas,73,18,47,65,0.169811,13.36
8480023,20212022,Robert Thomas,72,20,57,77,0.174,18.57
8480023,20202021,Robert Thomas,33,3,9,12,0.136,2.57
8480023,20192020,Robert Thomas,66,10,32,42,0.115,
8480023,20182019,Robert Thomas,70,9,24,33,0.1125,
8477573,20242025,Nathan Walker,73,8,8,16,0.111111,7.91
8477573,20232024,Nathan Walker,45,7,6,13,0.162791,4.09
8477573,20222023,Nathan Walker,56,2,8,10,0.046512,4.32
8477573,20212022,Nathan Walker,30,8,4,12,0.211,4.61
8477573,20202021,Nathan Walker,8,1,0,1,0.1,1.04
8477573,20192020,Nathan Walker,5,1,1,2,0.167,
8477573,20182019,Nathan Walker,3,0,1,1,0.0,
8477573,20172018,Nathan Walker,2,0,0,0,0.0,
8475753,20242025,Justin Faulk,78,4,28,32,0.032258,6.01
8475753,20232024,Justin Faulk,60,2,28,30,0.015152,7.97
8475753,20222023,Justin Faulk,82,11,39,50,0.056122,8.96
8475753,20212022,Justin Faulk,76,16,31,47,0.096,9.99
8475753,20202021,Justin Faulk,56,7,18,25,0.06,5.52
8475753,20192020,Justin Faulk,69,5,11,16,0.034,
8475753,20182019,Justin Faulk,82,11,24,35,0.0507,
8475753,20172018,Justin Faulk,76,8,23,31,0.0379,
8475753,20162017,Justin Faulk,75,17,20,37,0.0756,
8475753,20152016,Justin Faulk,64,16,21,37,0.087,
8475753,20142015,Justin Faulk,82,15,34,49,0.063,
8475753,20132014,Justin Faulk,76,5,27,32,0.0329,
8475753,20122013,Justin Faulk,38,5,10,15,0.0658,
8475753,20112012,Justin Faulk,66,8,14,22,0.0792,
8475764,20242025,Cam Fowler,51,9,27,36,0.126761,5.12
8475764,20232024,Cam Fowler,81,5,34,39,0.045872,5.99
8475764,20222023,Cam Fowler,82,10,38,48,0.076923,8.36
8475764,20212022,Cam Fowler,76,9,33,42,0.073,9.21
8475764,20202021,Cam Fowler,56,5,18,23,0.067,3.36
8475764,20192020,Cam Fowler,59,9,20,29,0.077,
8475764,20182019,Cam Fowler,59,5,18,23,0.0568,
8475764,20172018,Cam Fowler,67,8,24,32,0.0656,
8475764,20162017,Cam Fowler,80,11,28,39,0.0591,
8475764,20152016,Cam Fowler,69,5,23,28,0.0442,
8475764,20142015,Cam Fowler,80,7,27,34,0.0805,
8475764,20132014,Cam Fowler,70,6,30,36,0.06,
8475764,20122013,Cam Fowler,37,1,10,11,0.02,
8475764,20112012,Cam Fowler,82,5,24,29,0.0407,
8475764,20102011,Cam Fowler,76,10,30,40,0.0813,
8476892,20242025,Colton Parayko,64,16,20,36,0.128,7.89
8476892,20232024,Colton Parayko,82,10,16,26,0.064935,6.33
8476892,20222023,Colton Parayko,79,4,23,27,0.030075,5.42
8476892,20212022,Colton Parayko,80,6,29,35,0.044,7.35
8476892,20202021,Colton Parayko,32,2,10,12,0.033,2.45
8476892,20192020,Colton Parayko,64,10,18,28,0.062,
8476892,20182019,Colton Parayko,80,10,18,28,0.0568,
8476892,20172018,Colton Parayko,82,6,29,35,0.0283,
8476892,20162017,Colton Parayko,81,4,31,35,0.0213,
8476892,20152016,Colton Parayko,79,9,24,33,0.0545,
8477416,20242025,Oliver Bjorkstrand,18,5,4,9,0.166667,16.86
8477416,20232024,Oliver Bjorkstrand,82,20,39,59,0.107527,17.58
8477416,20222023,Oliver Bjorkstrand,81,20,25,45,0.10101,23.26
8477416,20212022,Oliver Bjorkstrand,80,28,29,57,0.13,27.85
8477416,20202021,Oliver Bjorkstrand,56,18,26,44,0.126,13
8477416,20192020,Oliver Bjorkstrand,49,21,15,36,0.13,
8477416,20182019,Oliver Bjorkstrand,77,23,13,36,0.1429,
8477416,20172018,Oliver Bjorkstrand,82,11,29,40,0.0675,
8477416,20162017,Oliver Bjorkstrand,26,6,7,13,0.1091,
8477416,20152016,Oliver Bjorkstrand,12,4,4,8,0.16,
8478519,20242025,Anthony Cirelli,80,27,32,59,0.16875,28.34
8478519,20232024,Anthony Cirelli,79,20,25,45,0.155039,18.81
8478519,20222023,Anthony Cirelli,58,11,18,29,0.099099,18.05
8478519,20212022,Anthony Cirelli,76,17,26,43,0.116,18.23
8478519,20202021,Anthony Cirelli,50,9,13,22,0.12,8.96
8478519,20192020,Anthony Cirelli,68,16,28,44,0.142,
8478519,20182019,Anthony Cirelli,82,19,20,39,0.1545,
8478519,20172018,Anthony Cirelli,18,5,6,11,0.1923,
8476878,20242025,Zemgus Girgensons,82,2,4,6,0.024096,8.92
8476878,20232024,Zemgus Girgensons,63,8,6,14,0.109589,8.12
8476878,20222023,Zemgus Girgensons,80,10,8,18,0.087719,13.55
8476878,20212022,Zemgus Girgensons,56,10,8,18,0.109,8.89
8476826,20242025,Yanni Gourde,21,1,13,14,0.028571,13.12
8476826,20232024,Yanni Gourde,80,11,22,33,0.070513,20.95
8476826,20222023,Yanni Gourde,81,14,34,48,0.099291,17.84
8476826,20212022,Yanni Gourde,74,21,27,48,0.165,15.36
8476826,20202021,Yanni Gourde,56,17,19,36,0.144,15.65
8476826,20192020,Yanni Gourde,70,10,20,30,0.091,
8476826,20182019,Yanni Gourde,80,22,26,48,0.1692,
8476826,20172018,Yanni Gourde,82,25,39,64,0.1838,
8476826,20162017,Yanni Gourde,20,6,2,8,0.2,
8476826,20152016,Yanni Gourde,2,0,1,1,0.0,
8477404,20242025,Jake Guentzel,80,41,39,80,0.18894,34.75
8477404,20232024,Jake Guentzel,17,8,17,25,0.150943,38.64
8477404,20222023,Jake Guentzel,78,36,37,73,0.147541,38.93
8477404,20212022,Jake Guentzel,76,40,44,84,0.152,37.28
8477404,20202021,Jake Guentzel,56,23,34,57,0.163,21.91
8477404,20192020,Jake Guentzel,39,20,23,43,0.157,
8477404,20182019,Jake Guentzel,82,40,36,76,0.1762,
8477404,20172018,Jake Guentzel,82,22,26,48,0.1287,
8477404,20162017,Jake Guentzel,40,16,17,33,0.1975,
8479542,20242025,Brandon Hagel,82,35,55,90,0.153509,32.55
8479542,20232024,Brandon Hagel,82,26,49,75,0.141304,30.8
8479542,20222023,Brandon Hagel,81,30,34,64,0.168539,30.52
8479542,20212022,Brandon Hagel,22,4,3,7,0.129,17.92
8479542,20202021,Brandon Hagel,52,9,15,24,0.099,8.47
8479542,20192020,Brandon Hagel,1,0,0,0,0.0,
8476453,20242025,Nikita Kucherov,78,37,84,121,0.139623,27.03
8476453,20232024,Nikita Kucherov,81,44,100,144,0.143791,34
8476453,20222023,Nikita Kucherov,82,30,83,113,0.110701,30.23
8476453,20212022,Nikita Kucherov,47,25,44,69,0.16,16.46
8477426,20242025,Nick Paul,76,22,19,41,0.156028,18.84
8477426,20232024,Nick Paul,82,24,22,46,0.156863,22.83
8477426,20222023,Nick Paul,80,17,15,32,0.141667,17.48
8477426,20212022,Nick Paul,21,5,9,14,0.143,18.75
8477426,20202021,Nick Paul,56,5,15,20,0.048,8.89
8477426,20192020,Nick Paul,56,9,11,20,0.087,
8477426,20182019,Nick Paul,20,1,1,2,0.0333,
8477426,20172018,Nick Paul,11,1,0,1,0.0909,
8477426,20162017,Nick Paul,1,0,0,0,0.0,
8477426,20152016,Nick Paul,24,2,3,5,0.0714,
8478010,20242025,Brayden Point,77,42,40,82,0.222222,31.02
8478010,20232024,Brayden Point,81,46,44,90,0.202643,37.33
8478010,20222023,Brayden Point,82,51,44,95,0.217021,39.6
8478010,20212022,Brayden Point,66,28,30,58,0.159,26.43
8478010,20202021,Brayden Point,56,23,25,48,0.176,17.72
8478010,20192020,Brayden Point,66,25,39,64,0.177,
8478010,20182019,Brayden Point,79,41,51,92,0.2147,
8478010,20172018,Brayden Point,82,32,34,66,0.1475,
8478010,20162017,Brayden Point,68,18,22,40,0.1475,
8477149,20242025,Scott Sabourin,1,0,0,0,0.0,0
8477149,20232024,Scott Sabourin,3,0,0,0,0.0,0.19
8478416,20242025,Erik Cernak,76,3,18,21,0.046875,3.06
8478416,20232024,Erik Cernak,69,2,11,13,0.037736,2.41
8478416,20222023,Erik Cernak,70,2,14,16,0.022989,3.98
8478416,20212022,Erik Cernak,55,1,12,13,0.012,2.91
8478416,20202021,Erik Cernak,46,5,13,18,0.059,3.25
8478416,20192020,Erik Cernak,67,5,7,12,0.04,
8478416,20182019,Erik Cernak,58,5,11,16,0.0467,
8475167,20242025,Victor Hedman,79,15,51,66,0.082873,12.17
8475167,20232024,Victor Hedman,78,13,63,76,0.077381,12.7
8475167,20222023,Victor Hedman,76,9,40,49,0.048649,9.41
8475167,20212022,Victor Hedman,82,20,65,85,0.091,14.75
8475167,20202021,Victor Hedman,54,9,36,45,0.066,8.4
8475167,20192020,Victor Hedman,66,11,44,55,0.071,
8475167,20182019,Victor Hedman,70,12,42,54,0.0659,
8475167,20172018,Victor Hedman,77,17,46,63,0.0787,
8475167,20162017,Victor Hedman,79,16,56,72,0.0964,
8475167,20152016,Victor Hedman,78,10,37,47,0.0556,
8475167,20142015,Victor Hedman,59,10,28,38,0.087,
8475167,20132014,Victor Hedman,75,13,42,55,0.0765,
8475167,20122013,Victor Hedman,44,4,16,20,0.0526,
8475167,20112012,Victor Hedman,61,5,18,23,0.061,
8475167,20102011,Victor Hedman,79,3,23,26,0.0297,
8475167,20092010,Victor Hedman,74,4,16,20,0.0444,
8474151,20242025,Ryan McDonagh,82,4,27,31,0.051282,4.31
8474151,20232024,Ryan McDonagh,74,3,29,32,0.032967,3.37
8474151,20222023,Ryan McDonagh,71,2,18,20,0.025641,4.84
8474151,20212022,Ryan McDonagh,71,4,22,26,0.047,5.51
8474151,20202021,Ryan McDonagh,50,4,8,12,0.047,4.42
8474151,20192020,Ryan McDonagh,50,1,11,12,0.02,
8474151,20182019,Ryan McDonagh,82,9,37,46,0.0703,
8474151,20172018,Ryan McDonagh,14,2,1,3,0.0909,
8474151,20162017,Ryan McDonagh,77,6,36,42,0.0392,
8474151,20152016,Ryan McDonagh,73,9,25,34,0.0796,
8474151,20142015,Ryan McDonagh,71,8,25,33,0.0541,
8474151,20132014,Ryan McDonagh,77,14,29,43,0.0791,
8474151,20122013,Ryan McDonagh,47,4,15,19,0.0482,
8474151,20112012,Ryan McDonagh,82,7,25,32,0.0569,
8474151,20102011,Ryan McDonagh,40,1,8,9,0.037,
8477463,20242025,Steven Santini,1,0,0,0,0.0,0.04
8476329,20242025,Travis Boyd,3,0,0,0,0.0,0.07
8476329,20232024,Travis Boyd,16,2,6,8,0.166667,1.17
8476329,20222023,Travis Boyd,82,15,19,34,0.159574,13.95
8476329,20212022,Travis Boyd,74,17,18,35,0.193,12.95
8476329,20202021,Travis Boyd,19,2,0,2,0.25,3.58
8476329,20192020,Travis Boyd,24,3,7,10,0.115,
8476329,20182019,Travis Boyd,53,5,15,20,0.1429,
8476329,20172018,Travis Boyd,8,0,1,1,0.0,
8477503,20242025,Max Domi,74,8,25,33,0.086022,8.84
8477503,20232024,Max Domi,80,9,38,47,0.065693,11.92
8477503,20222023,Max Domi,20,2,5,7,0.055556,20.89
8477503,20212022,Max Domi,19,2,5,7,0.074,11.28
8477503,20202021,Max Domi,54,9,15,24,0.091,6.06
8477503,20192020,Max Domi,71,17,27,44,0.095,
8477503,20182019,Max Domi,82,28,44,72,0.1379,
8477503,20172018,Max Domi,82,9,36,45,0.06,
8477503,20162017,Max Domi,59,9,29,38,0.0833,
8477503,20152016,Max Domi,81,18,34,52,0.1154,
8475714,20242025,Calle Jarnkrok,19,1,6,7,0.111111,1.99
8475714,20232024,Calle Jarnkrok,52,10,11,21,0.108696,12.8
8475714,20222023,Calle Jarnkrok,73,20,19,39,0.188679,14.43
8475714,20212022,Calle Jarnkrok,17,0,4,4,0.0,11.72
8475714,20202021,Calle Jarnkrok,49,13,15,28,0.143,8.99
8475714,20192020,Calle Jarnkrok,64,15,19,34,0.11,
8475714,20182019,Calle Jarnkrok,79,10,16,26,0.0943,
8475714,20172018,Calle Jarnkrok,68,16,19,35,0.1524,
8475714,20162017,Calle Jarnkrok,81,15,16,31,0.1119,
8475714,20152016,Calle Jarnkrok,81,16,14,30,0.128,
8475714,20142015,Calle Jarnkrok,74,7,11,18,0.0737,
8475714,20132014,Calle Jarnkrok,12,2,7,9,0.1538,
8478057,20242025,Dakota Joshua,57,7,7,14,0.134615,10.74
8478057,20232024,Dakota Joshua,63,18,14,32,0.214286,14.12
8478057,20222023,Dakota Joshua,79,11,12,23,0.15493,13.19
8478057,20212022,Dakota Joshua,30,3,5,8,0.097,4.37
8478057,20202021,Dakota Joshua,12,1,0,1,0.111,0.56
8480144,20242025,David Kampf,59,5,8,13,0.111111,5.81
8480144,20232024,David Kampf,78,8,11,19,0.101266,8.18
8480144,20222023,David Kampf,82,7,20,27,0.065421,13.86
8480144,20212022,David Kampf,82,11,15,26,0.108,12.43
8480144,20202021,David Kampf,56,1,11,12,0.016,5.79
8480144,20192020,David Kampf,70,8,8,16,0.089,
8480144,20182019,David Kampf,63,4,15,19,0.0556,
8480144,20172018,David Kampf,46,4,7,11,0.087,
8476872,20242025,Scott Laughton,20,2,2,4,0.1,17.85
8476872,20232024,Scott Laughton,82,13,26,39,0.077844,14.55
8476872,20222023,Scott Laughton,78,18,25,43,0.105882,18.25
8476872,20212022,Scott Laughton,67,11,19,30,0.1,14.44
8476872,20202021,Scott Laughton,53,9,11,20,0.101,7.15
8476872,20192020,Scott Laughton,49,13,14,27,0.176,
8476872,20182019,Scott Laughton,82,12,20,32,0.0923,
8476872,20172018,Scott Laughton,81,10,10,20,0.0926,
8476872,20162017,Scott Laughton,2,0,0,0,0.0,
8476872,20152016,Scott Laughton,71,7,14,21,0.0824,
8476872,20142015,Scott Laughton,31,2,4,6,0.0392,
8479968,20242025,Vinni Lettieri,26,3,2,5,0.057692,5.53
8479968,20232024,Vinni Lettieri,46,5,4,9,0.106383,4.23
8479968,20222023,Vinni Lettieri,1,0,0,0,0.0,0.02
8479968,20212022,Vinni Lettieri,31,5,5,10,0.1,4.25
8479968,20202021,Vinni Lettieri,5,0,0,0,0.0,0.28
8478904,20242025,Steven Lorentz,80,8,11,19,0.105263,8.42
8478904,20232024,Steven Lorentz,38,1,2,3,0.033333,3.62
8478904,20222023,Steven Lorentz,80,10,9,19,0.09009,13.68
8478904,20212022,Steven Lorentz,67,8,5,13,0.1,11.09
8478904,20202021,Steven Lorentz,45,2,6,8,0.05,5.06
8479318,20242025,Auston Matthews,67,33,45,78,0.126437,41.05
8479318,20232024,Auston Matthews,81,69,38,107,0.186992,50.77
8479318,20222023,Auston Matthews,74,40,45,85,0.122324,38.49
8479318,20212022,Auston Matthews,73,60,46,106,0.172,41.86
8479318,20202021,Auston Matthews,52,41,25,66,0.185,30.04
8479318,20192020,Auston Matthews,70,47,33,80,0.162,
8479318,20182019,Auston Matthews,68,37,36,73,0.1474,
8479318,20172018,Auston Matthews,62,34,29,63,0.1818,
8479318,20162017,Auston Matthews,82,40,29,69,0.1434,
8477939,20242025,William Nylander,82,45,39,84,0.177866,31.18
8477939,20232024,William Nylander,82,40,58,98,0.126582,30.99
8477939,20222023,William Nylander,82,40,47,87,0.136519,32.92
8477939,20212022,William Nylander,81,34,46,80,0.133,28.22
8477939,20202021,William Nylander,51,17,25,42,0.128,17.69
8477939,20192020,William Nylander,68,31,28,59,0.157,
8477939,20182019,William Nylander,54,7,20,27,0.0538,
8477939,20172018,William Nylander,82,20,41,61,0.1087,
8477939,20162017,William Nylander,81,22,39,61,0.1073,
8477939,20152016,William Nylander,22,6,7,13,0.1395,
8481582,20242025,Nicholas Robertson,69,15,7,22,0.133929,10.61
8481582,20232024,Nicholas Robertson,56,14,13,27,0.145833,8.83
8481582,20222023,Nicholas Robertson,15,2,3,5,0.074074,2.41
8481582,20212022,Nicholas Robertson,10,1,0,1,0.071,0.65
8481582,20202021,Nicholas Robertson,6,0,1,1,0.0,0.79
8478462,20242025,Nicolas Roy,71,15,16,31,0.140187,15.49
8478462,20232024,Nicolas Roy,70,13,28,41,0.116071,17.44
8478462,20222023,Nicolas Roy,65,14,16,30,0.138614,15.86
8478462,20212022,Nicolas Roy,78,15,24,39,0.103,21.82
8478462,20202021,Nicolas Roy,50,6,9,15,0.115,6.11
8478462,20192020,Nicolas Roy,28,5,5,10,0.119,
8478462,20182019,Nicolas Roy,6,0,0,0,0.0,
8478462,20172018,Nicolas Roy,1,0,0,0,0.0,
8475166,20242025,John Tavares,75,38,36,74,0.19,32.37
8475166,20232024,John Tavares,80,29,36,65,0.103943,41.72
8475166,20222023,John Tavares,80,36,44,80,0.129964,45.11
8475166,20212022,John Tavares,79,27,49,76,0.114,33.38
8475166,20202021,John Tavares,56,19,31,50,0.117,23.22
8475166,20192020,John Tavares,63,26,34,60,0.132,
8475166,20182019,John Tavares,82,47,41,88,0.1643,
8475166,20172018,John Tavares,82,37,47,84,0.144,
8475166,20162017,John Tavares,77,28,38,66,0.1077,
8475166,20152016,John Tavares,78,33,37,70,0.132,
8475166,20142015,John Tavares,82,38,48,86,0.1367,
8475166,20132014,John Tavares,59,24,42,66,0.1277,
8475166,20122013,John Tavares,48,28,19,47,0.1728,
8475166,20112012,John Tavares,82,31,50,81,0.1084,
8475166,20102011,John Tavares,79,29,38,67,0.1193,
8475166,20092010,John Tavares,82,24,30,54,0.129,
8476988,20242025,Matt Benning,7,0,0,0,0.0,0.34
8476988,20232024,Matt Benning,14,0,2,2,0.0,0.4
8476988,20222023,Matt Benning,77,1,23,24,0.017241,2.86
8476988,20212022,Matt Benning,65,0,11,11,0.0,2
8476988,20202021,Matt Benning,53,1,3,4,0.023,1.08
8476988,20192020,Matt Benning,43,1,7,8,0.026,
8476988,20182019,Matt Benning,70,5,12,17,0.0532,
8476988,20172018,Matt Benning,73,6,15,21,0.0541,
8476988,20162017,Matt Benning,62,3,12,15,0.0435,
8481122,20242025,Simon Benoit,78,1,9,10,0.020833,1.71
8481122,20232024,Simon Benoit,64,1,4,5,0.019231,1.58
8481122,20222023,Simon Benoit,78,3,7,10,0.036585,3.73
8481122,20212022,Simon Benoit,53,1,4,5,0.022,1.62
8481122,20202021,Simon Benoit,6,0,0,0,0.0,0.17
8478443,20242025,Brandon Carlo,20,0,3,3,0.0,3.3
8478443,20232024,Brandon Carlo,76,4,10,14,0.050633,2.68
8478443,20222023,Brandon Carlo,75,3,13,16,0.031915,4.8
8478443,20212022,Brandon Carlo,79,6,9,15,0.048,3.69
8478443,20202021,Brandon Carlo,27,3,1,4,0.07,1.31
8478443,20192020,Brandon Carlo,67,4,15,19,0.036,
8478443,20182019,Brandon Carlo,72,2,8,10,0.0172,
8478443,20172018,Brandon Carlo,76,0,6,6,0.0,
8478443,20162017,Brandon Carlo,82,6,10,16,0.0682,
8475171,20242025,Oliver Ekman-Larsson,77,4,25,29,0.033898,5.64
8475171,20232024,Oliver Ekman-Larsson,80,9,23,32,0.073171,7.03
8475171,20222023,Oliver Ekman-Larsson,54,2,20,22,0.022222,2.5
8475171,20212022,Oliver Ekman-Larsson,79,5,24,29,0.03,6.45
8475171,20202021,Oliver Ekman-Larsson,46,3,21,24,0.036,3.24
8475171,20192020,Oliver Ekman-Larsson,66,9,21,30,0.067,
8475171,20182019,Oliver Ekman-Larsson,81,14,30,44,0.0795,
8475171,20172018,Oliver Ekman-Larsson,82,14,28,42,0.0693,
8475171,20162017,Oliver Ekman-Larsson,79,12,27,39,0.0828,
8475171,20152016,Oliver Ekman-Larsson,75,21,34,55,0.0921,
8475171,20142015,Oliver Ekman-Larsson,82,23,20,43,0.0871,
8475171,20132014,Oliver Ekman-Larsson,80,15,29,44,0.0754,
8475171,20122013,Oliver Ekman-Larsson,48,3,21,24,0.0297,
8475171,20112012,Oliver Ekman-Larsson,82,13,19,32,0.0884,
8475171,20102011,Oliver Ekman-Larsson,48,1,10,11,0.02,
8476931,20242025,Jake McCabe,66,2,21,23,0.027027,2.98
8476931,20232024,Jake McCabe,73,8,20,28,0.109589,3.72
8476931,20222023,Jake McCabe,21,1,4,5,0.034483,4.44
8476931,20212022,Jake McCabe,75,4,18,22,0.05,4.42
8476931,20202021,Jake McCabe,13,1,2,3,0.067,0.6
8476931,20192020,Jake McCabe,66,3,10,13,0.04,
8476931,20182019,Jake McCabe,59,4,10,14,0.0625,
8476931,20172018,Jake McCabe,53,3,9,12,0.0566,
8476931,20162017,Jake McCabe,76,3,17,20,0.038,
8476931,20152016,Jake McCabe,77,4,10,14,0.0645,
8476931,20142015,Jake McCabe,2,0,0,0,0.0,
8476931,20132014,Jake McCabe,7,0,1,1,0.0,
8477541,20242025,Dakota Mermis,3,0,1,1,0.0,0.42
8477541,20232024,Dakota Mermis,47,3,5,8,0.071429,1.79
8477541,20222023,Dakota Mermis,2,0,0,0,0.0,0.04
8477541,20212022,Dakota Mermis,2,0,0,0,0.0,0.02
8477541,20202021,Dakota Mermis,3,0,0,0,0.0,0.07
8477541,20192020,Dakota Mermis,10,1,3,4,0.059,
8477541,20182019,Dakota Mermis,1,0,0,0,0.0,
8477541,20172018,Dakota Mermis,9,0,0,0,0.0,
8479026,20242025,Philippe Myers,36,2,3,5,0.043478,1.51
8479026,20232024,Philippe Myers,5,0,0,0,0.0,0.17
8479026,20222023,Philippe Myers,11,1,2,3,0.047619,0.53
8479026,20212022,Philippe Myers,27,1,3,4,0.036,1.17
8479026,20202021,Philippe Myers,44,1,10,11,0.013,2.74
8479026,20192020,Philippe Myers,50,4,12,16,0.051,
8479026,20182019,Philippe Myers,21,1,1,2,0.04,
8476853,20242025,Morgan Rielly,82,7,34,41,0.055556,5.48
8476853,20232024,Morgan Rielly,72,7,51,58,0.040462,9.67
8476853,20222023,Morgan Rielly,65,4,37,41,0.031746,6.77
8476853,20212022,Morgan Rielly,82,10,58,68,0.045,9.35
8476853,20202021,Morgan Rielly,55,5,30,35,0.05,5.52
8476853,20192020,Morgan Rielly,47,3,24,27,0.024,
8476853,20182019,Morgan Rielly,82,20,52,72,0.0897,
8476853,20172018,Morgan Rielly,76,6,46,52,0.033,
8476853,20162017,Morgan Rielly,76,6,21,27,0.0351,
8476853,20152016,Morgan Rielly,82,9,27,36,0.0539,
8476853,20142015,Morgan Rielly,81,8,21,29,0.0541,
8476853,20132014,Morgan Rielly,73,2,25,27,0.0208,
8475690,20242025,Chris Tanev,75,3,15,18,0.069767,1.66
8475690,20232024,Chris Tanev,19,1,4,5,0.076923,1.3
8475690,20222023,Chris Tanev,65,1,12,13,0.013333,1.69
8475690,20212022,Chris Tanev,82,6,22,28,0.068,3.21
8475690,20202021,Chris Tanev,56,2,10,12,0.03,2.08
8475690,20192020,Chris Tanev,69,2,18,20,0.044,
8475690,20182019,Chris Tanev,55,2,10,12,0.0392,
8475690,20172018,Chris Tanev,42,2,9,11,0.0645,
8475690,20162017,Chris Tanev,53,2,8,10,0.0513,
8475690,20152016,Chris Tanev,69,4,14,18,0.0952,
8475690,20142015,Chris Tanev,70,2,18,20,0.0377,
8475690,20132014,Chris Tanev,64,6,11,17,0.0923,
8475690,20122013,Chris Tanev,38,2,5,7,0.1,
8475690,20112012,Chris Tanev,25,0,2,2,0.0,
8475690,20102011,Chris Tanev,29,0,1,1,0.0,
8478474,20242025,Lawson Crouse,81,12,6,18,0.095238,15.95
8478474,20232024,Lawson Crouse,81,23,19,42,0.134503,21.53
8478474,20222023,Lawson Crouse,77,24,21,45,0.15894,19.75
8478474,20212022,Lawson Crouse,65,20,14,34,0.153,14.97
8478474,20202021,Lawson Crouse,51,4,9,13,0.057,8.75
8478474,20192020,Lawson Crouse,66,15,10,25,0.138,
8478474,20182019,Lawson Crouse,81,11,14,25,0.084,
8478474,20172018,Lawson Crouse,11,1,0,1,0.0769,
8478474,20162017,Lawson Crouse,72,5,7,12,0.0595,
8480849,20242025,Barrett Hayton,82,20,26,46,0.129032,30.51
8480849,20232024,Barrett Hayton,33,3,7,10,0.045455,8.53
8480849,20222023,Barrett Hayton,82,19,24,43,0.106742,21.87
8480849,20212022,Barrett Hayton,60,10,14,24,0.122,10.91
8480849,20202021,Barrett Hayton,14,2,1,3,0.2,0.78
8480849,20192020,Barrett Hayton,20,1,3,4,0.037,
8479343,20242025,Clayton Keller,81,30,60,90,0.137615,29.87
8479343,20232024,Clayton Keller,78,33,43,76,0.144737,24.88
8479343,20222023,Clayton Keller,82,37,49,86,0.165919,24.95
8479343,20212022,Clayton Keller,67,28,35,63,0.158,20.52
8479343,20202021,Clayton Keller,56,14,21,35,0.113,13.65
8479343,20192020,Clayton Keller,70,17,27,44,0.092,
8479343,20182019,Clayton Keller,82,14,33,47,0.07,
8479343,20172018,Clayton Keller,82,23,42,65,0.1085,
8479343,20162017,Clayton Keller,3,0,2,2,0.0,
8477021,20242025,Alexander Kerfoot,81,11,17,28,0.108911,16.23
8477021,20232024,Alexander Kerfoot,82,13,32,45,0.126214,18.91
8477021,20222023,Alexander Kerfoot,82,10,22,32,0.075188,16.81
8477021,20212022,Alexander Kerfoot,82,13,38,51,0.111,14.74
8477021,20202021,Alexander Kerfoot,56,8,15,23,0.118,9.66
8477021,20192020,Alexander Kerfoot,65,9,19,28,0.102,
8477021,20182019,Alexander Kerfoot,78,15,27,42,0.1293,
8477021,20172018,Alexander Kerfoot,79,19,24,43,0.2346,
8477070,20242025,Liam O'Brien,28,0,2,2,0.0,4.63
8477070,20232024,Liam O'Brien,75,5,9,14,0.069444,8.55
8477070,20222023,Liam O'Brien,56,3,8,11,0.076923,4.59
8477070,20212022,Liam O'Brien,39,2,1,3,0.056,3.97
8477070,20202021,Liam O'Brien,12,0,3,3,0.0,0.45
8477951,20242025,Nick Schmaltz,82,20,43,63,0.107527,26.2
8477951,20232024,Nick Schmaltz,79,22,39,61,0.139241,21.77
8477951,20222023,Nick Schmaltz,63,22,36,58,0.166667,16.75
8477951,20212022,Nick Schmaltz,63,23,36,59,0.187,14.3
8477951,20202021,Nick Schmaltz,52,10,22,32,0.095,12.4
8477951,20192020,Nick Schmaltz,70,11,34,45,0.116,
8477951,20182019,Nick Schmaltz,17,5,9,14,0.1724,
8477951,20172018,Nick Schmaltz,78,21,31,52,0.178,
8477951,20162017,Nick Schmaltz,61,6,22,28,0.0909,
8478831,20242025,Kevin Stenlund,82,14,14,28,0.137255,12.47
8478831,20232024,Kevin Stenlund,81,11,4,15,0.135802,8.72
8478831,20222023,Kevin Stenlund,54,6,3,9,0.095238,7.58
8478831,20212022,Kevin Stenlund,3,0,0,0,0.0,0.19
8478831,20202021,Kevin Stenlund,32,5,5,10,0.119,4.02
8478831,20192020,Kevin Stenlund,32,6,4,10,0.105,
8478831,20182019,Kevin Stenlund,4,0,0,0,0.0,
8479293,20242025,Brandon Tanev,19,1,4,5,0.071429,13.19
8479293,20232024,Brandon Tanev,66,7,9,16,0.09589,10.57
8479293,20222023,Brandon Tanev,82,16,19,35,0.13913,19.55
8479293,20212022,Brandon Tanev,30,9,6,15,0.176,8.47
8479293,20202021,Brandon Tanev,32,7,9,16,0.163,5.98
8479293,20192020,Brandon Tanev,68,11,14,25,0.116,
8479293,20182019,Brandon Tanev,80,14,15,29,0.1102,
8479293,20172018,Brandon Tanev,61,8,10,18,0.1013,
8479293,20162017,Brandon Tanev,51,2,2,4,0.037,
8479293,20152016,Brandon Tanev,3,0,0,0,0.0,
8479977,20242025,Kailer Yamamoto,12,2,1,3,0.153846,3.09
8479977,20232024,Kailer Yamamoto,59,8,8,16,0.131148,8.95
8479977,20222023,Kailer Yamamoto,58,10,15,25,0.103093,14.63
8479977,20212022,Kailer Yamamoto,81,20,21,41,0.175,18.74
8479977,20202021,Kailer Yamamoto,52,8,13,21,0.116,11.99
8479977,20192020,Kailer Yamamoto,27,11,15,26,0.25,
8479977,20182019,Kailer Yamamoto,17,1,1,2,0.0769,
8479977,20172018,Kailer Yamamoto,9,0,3,3,0.0,
8474013,20242025,Ian Cole,82,1,16,17,0.015152,5.22
8474013,20232024,Ian Cole,78,2,9,11,0.032787,2.05
8474013,20222023,Ian Cole,78,3,14,17,0.027523,4.41
8474013,20212022,Ian Cole,75,2,17,19,0.026,2.78
8474013,20202021,Ian Cole,52,1,7,8,0.036,1.23
8474013,20192020,Ian Cole,65,4,22,26,0.043,
8474013,20182019,Ian Cole,71,2,13,15,0.0244,
8474013,20172018,Ian Cole,20,2,5,7,0.0952,
8474013,20162017,Ian Cole,81,5,21,26,0.0562,
8474013,20152016,Ian Cole,70,0,12,12,0.0,
8474013,20142015,Ian Cole,20,1,7,8,0.0323,
8474013,20132014,Ian Cole,46,3,8,11,0.0667,
8474013,20122013,Ian Cole,15,0,1,1,0.0,
8474013,20112012,Ian Cole,26,1,5,6,0.0556,
8474013,20102011,Ian Cole,26,1,3,4,0.0455,
8478507,20242025,John Marino,35,1,13,14,0.033333,1.79
8478507,20232024,John Marino,75,4,21,25,0.070175,5.12
8478507,20222023,John Marino,64,4,14,18,0.059701,4.72
8478507,20212022,John Marino,81,1,24,25,0.011,4.35
8478507,20202021,John Marino,52,3,10,13,0.054,2.46
8478507,20192020,John Marino,56,6,20,26,0.098,
8476874,20242025,Olli Määttä,70,2,16,18,0.028571,4.67
8476874,20232024,Olli Määttä,72,4,14,18,0.083333,2.92
8476874,20222023,Olli Määttä,78,6,17,23,0.096774,2.83
8476874,20212022,Olli Määttä,66,1,7,8,0.016,2.44
8476874,20202021,Olli Määttä,41,0,4,4,0.0,1.62
8476874,20192020,Olli Määttä,65,4,13,17,0.05,
8476874,20182019,Olli Määttä,60,1,13,14,0.0135,
8476874,20172018,Olli Määttä,82,7,22,29,0.0427,
8476874,20162017,Olli Määttä,55,1,6,7,0.0152,
8476874,20152016,Olli Määttä,67,6,13,19,0.0632,
8476874,20142015,Olli Määttä,20,1,8,9,0.037,
8476874,20132014,Olli Määttä,78,9,20,29,0.0756,
8477220,20242025,Nate Schmidt,80,5,14,19,0.071429,3.96
8477220,20232024,Nate Schmidt,63,2,12,14,0.026667,2.92
8477220,20222023,Nate Schmidt,71,7,12,19,0.069307,5.1
8477220,20212022,Nate Schmidt,77,4,28,32,0.034,5.43
8477220,20202021,Nate Schmidt,54,5,10,15,0.066,3.4
8477220,20192020,Nate Schmidt,59,7,24,31,0.063,
8477220,20182019,Nate Schmidt,61,9,21,30,0.0804,
8477220,20172018,Nate Schmidt,76,5,31,36,0.0485,
8477220,20162017,Nate Schmidt,60,3,14,17,0.05,
8477220,20152016,Nate Schmidt,72,2,14,16,0.025,
8477220,20142015,Nate Schmidt,39,1,3,4,0.025,
8477220,20132014,Nate Schmidt,29,2,4,6,0.0488,
8479410,20242025,Mikhail Sergachev,77,15,38,53,0.113636,7.08
8479410,20232024,Mikhail Sergachev,34,2,17,19,0.037736,2.75
8479410,20222023,Mikhail Sergachev,79,10,54,64,0.064103,7.27
8479410,20212022,Mikhail Sergachev,78,7,31,38,0.047,7.28
8479410,20202021,Mikhail Sergachev,56,4,26,30,0.037,5.09
8479410,20192020,Mikhail Sergachev,70,10,24,34,0.085,
8479410,20182019,Mikhail Sergachev,75,6,26,32,0.0469,
8479410,20172018,Mikhail Sergachev,79,9,31,40,0.0638,
8479410,20162017,Mikhail Sergachev,4,0,0,0,0.0,
8479976,20242025,Juuso Välimäki,43,2,3,5,0.05,2.68
8479976,20232024,Juuso Välimäki,68,2,15,17,0.028986,3.73
8479976,20222023,Juuso Välimäki,78,4,30,34,0.043011,6.18
8479976,20212022,Juuso Välimäki,9,0,2,2,0.0,0.34
8479976,20202021,Juuso Välimäki,49,2,9,11,0.028,2.64
8476927,20242025,Teddy Blueger,82,8,18,26,0.085106,13.86
8476927,20232024,Teddy Blueger,68,6,22,28,0.061856,12.64
8476927,20222023,Teddy Blueger,18,2,4,6,0.086957,11.1
8476927,20212022,Teddy Blueger,65,9,19,28,0.097,9.44
8476927,20202021,Teddy Blueger,43,7,15,22,0.143,4.97
8476927,20192020,Teddy Blueger,69,9,13,22,0.088,
8476927,20182019,Teddy Blueger,28,6,4,10,0.1818,
8478444,20242025,Brock Boeser,75,25,25,50,0.172414,19.05
8478444,20232024,Brock Boeser,81,40,33,73,0.196078,33.68
8478444,20222023,Brock Boeser,74,18,37,55,0.101124,20.83
8478444,20212022,Brock Boeser,71,23,23,46,0.118,25.26
8478444,20202021,Brock Boeser,56,23,26,49,0.163,18.99
8478444,20192020,Brock Boeser,57,16,29,45,0.095,
8478444,20182019,Brock Boeser,69,26,30,56,0.1244,
8478444,20172018,Brock Boeser,62,29,26,55,0.162,
8478444,20162017,Brock Boeser,9,4,1,5,0.16,
8480078,20242025,Filip Chytil,15,2,4,6,0.045455,14.28
8480078,20232024,Filip Chytil,10,0,6,6,0.0,1.34
8480078,20222023,Filip Chytil,74,22,23,45,0.124294,18.25
8480078,20212022,Filip Chytil,67,8,14,22,0.059,14.47
8480078,20202021,Filip Chytil,42,8,14,22,0.105,7.29
8480078,20192020,Filip Chytil,60,14,9,23,0.123,
8480078,20182019,Filip Chytil,75,11,12,23,0.0827,
8480078,20172018,Filip Chytil,9,1,2,3,0.0476,
8478498,20242025,Jake DeBrusk,82,28,20,48,0.163743,29.45
8478498,20232024,Jake DeBrusk,80,19,21,40,0.103825,25.14
8478498,20222023,Jake DeBrusk,64,27,23,50,0.141361,23.93
8478498,20212022,Jake DeBrusk,77,25,17,42,0.136,20.88
8478498,20202021,Jake DeBrusk,41,5,9,14,0.054,10.45
8478498,20192020,Jake DeBrusk,65,19,16,35,0.118,
8478498,20182019,Jake DeBrusk,68,27,15,42,0.1731,
8478498,20172018,Jake DeBrusk,70,16,27,43,0.1119,
8478856,20242025,Conor Garland,81,19,31,50,0.111111,22.51
8478856,20232024,Conor Garland,82,20,27,47,0.1,18.87
8478856,20222023,Conor Garland,81,17,29,46,0.101796,15.42
8478856,20212022,Conor Garland,77,19,33,52,0.094,18.45
8478856,20202021,Conor Garland,49,12,27,39,0.089,11.46
8478856,20192020,Conor Garland,68,22,17,39,0.139,
8478856,20182019,Conor Garland,47,13,5,18,0.1102,
8481535,20242025,Nils Hoglander,72,8,17,25,0.096386,11.13
8481535,20232024,Nils Hoglander,80,24,12,36,0.2,18.06
8481535,20222023,Nils Hoglander,25,3,6,9,0.103448,2.48
8481535,20212022,Nils Hoglander,60,10,8,18,0.076,14.08
8481535,20202021,Nils Hoglander,56,13,14,27,0.11,11.47
8482055,20242025,Drew O'Connor,31,4,5,9,0.114286,21.08
8482055,20232024,Drew O'Connor,79,16,17,33,0.1,23.36
8482055,20222023,Drew O'Connor,46,5,6,11,0.080645,6.84
8482055,20212022,Drew O'Connor,22,3,2,5,0.075,3.77
8482055,20202021,Drew O'Connor,10,0,1,1,0.0,0.4
8480012,20242025,Elias Pettersson,64,15,30,45,0.137615,13.01
8480012,20232024,Elias Pettersson,82,34,55,89,0.164251,27.32
8480012,20222023,Elias Pettersson,80,39,63,102,0.151751,30.48
8480012,20212022,Elias Pettersson,80,32,36,68,0.167,23.84
8480012,20202021,Elias Pettersson,26,10,11,21,0.159,8.24
8480012,20192020,Elias Pettersson,68,27,39,66,0.167,
8480012,20182019,Elias Pettersson,71,28,38,66,0.1944,
8480748,20242025,Kiefer Sherwood,78,19,21,40,0.134752,12.07
8480748,20232024,Kiefer Sherwood,68,10,17,27,0.090909,9.6
8480748,20222023,Kiefer Sherwood,32,7,6,13,0.122807,6.96
8480748,20212022,Kiefer Sherwood,11,1,1,2,0.111,0.84
8480748,20202021,Kiefer Sherwood,16,0,3,3,0.0,2.4
8480748,20192020,Kiefer Sherwood,10,0,1,1,0.0,
8480748,20182019,Kiefer Sherwood,50,6,6,12,0.1,
8478465,20242025,Guillaume Brisebois,3,0,0,0,0.0,0.07
8475762,20242025,Derek Forbort,54,2,9,11,0.051282,1.39
8475762,20232024,Derek Forbort,35,0,4,4,0.0,0.99
8475762,20222023,Derek Forbort,54,5,7,12,0.131579,1.6
8475762,20212022,Derek Forbort,76,4,10,14,0.063,2
8475762,20202021,Derek Forbort,56,2,10,12,0.03,2.15
8475762,20192020,Derek Forbort,7,0,0,0,0.0,
8475762,20182019,Derek Forbort,81,2,12,14,0.0267,
8475762,20172018,Derek Forbort,78,1,17,18,0.0128,
8475762,20162017,Derek Forbort,82,2,16,18,0.02,
8475762,20152016,Derek Forbort,14,1,1,2,0.0714,
8479425,20242025,Filip Hronek,61,5,28,33,0.060241,4.28
8479425,20232024,Filip Hronek,81,5,43,48,0.033784,6.94
8479425,20222023,Filip Hronek,4,0,1,1,0.0,5.55
8479425,20212022,Filip Hronek,78,5,33,38,0.038,7.46
8479425,20202021,Filip Hronek,56,2,24,26,0.018,5.38
8479425,20192020,Filip Hronek,65,9,22,31,0.072,
8479425,20182019,Filip Hronek,46,5,18,23,0.0685,
8480800,20242025,Quinn Hughes,68,16,60,76,0.083333,8.9
8480800,20232024,Quinn Hughes,82,17,75,92,0.085427,11.18
8480800,20222023,Quinn Hughes,78,7,69,76,0.045455,6.25
8480800,20212022,Quinn Hughes,76,8,60,68,0.053,6.36
8480800,20202021,Quinn Hughes,56,3,38,41,0.031,4.89
8480800,20192020,Quinn Hughes,68,8,45,53,0.063,
8480800,20182019,Quinn Hughes,5,0,3,3,0.0,
8480058,20242025,P.O Joseph,24,0,1,1,0.0,1.63
8480058,20232024,P.O Joseph,52,2,9,11,0.047619,1.21
8480058,20222023,P.O Joseph,75,5,16,21,0.046296,3.62
8480058,20212022,P.O Joseph,4,0,0,0,0.0,0.37
8480058,20202021,P.O Joseph,16,1,4,5,0.037,0.76
8474574,20242025,Tyler Myers,71,6,18,24,0.068966,4.9
8474574,20232024,Tyler Myers,77,5,24,29,0.053763,4.17
8474574,20222023,Tyler Myers,78,1,16,17,0.01,4.94
8474574,20212022,Tyler Myers,82,1,17,18,0.008,5.84
8474574,20202021,Tyler Myers,55,6,15,21,0.055,3.99
8474574,20192020,Tyler Myers,68,6,15,21,0.045,
8474574,20182019,Tyler Myers,80,9,22,31,0.0577,
8474574,20172018,Tyler Myers,82,6,30,36,0.04,
8474574,20162017,Tyler Myers,11,2,3,5,0.125,
8474574,20152016,Tyler Myers,73,9,18,27,0.0643,
8474574,20142015,Tyler Myers,24,3,12,15,0.0577,
8474574,20132014,Tyler Myers,62,9,13,22,0.0909,
8474574,20122013,Tyler Myers,39,3,5,8,0.0625,
8474574,20112012,Tyler Myers,55,8,15,23,0.0952,
8474574,20102011,Tyler Myers,80,10,27,37,0.082,
8474574,20092010,Tyler Myers,82,11,37,48,0.1058,
8477969,20242025,Marcus Pettersson,31,1,10,11,0.037037,3.68
8477969,20232024,Marcus Pettersson,82,4,26,30,0.037736,4.44
8477969,20222023,Marcus Pettersson,68,1,23,24,0.010417,5.9
8477969,20212022,Marcus Pettersson,72,2,17,19,0.024,3.24
8477969,20202021,Marcus Pettersson,47,2,7,9,0.043,2.04
8477969,20192020,Marcus Pettersson,69,2,20,22,0.025,
8477969,20182019,Marcus Pettersson,57,2,17,19,0.0278,
8477969,20172018,Marcus Pettersson,22,1,3,4,0.0625,
8477964,20242025,Ivan Barbashev,70,23,28,51,0.207207,18.33
8477964,20232024,Ivan Barbashev,82,19,26,45,0.155738,18.39
8477964,20222023,Ivan Barbashev,23,6,10,16,0.171429,17.04
8477964,20212022,Ivan Barbashev,81,26,34,60,0.234,18.55
8477964,20202021,Ivan Barbashev,38,5,7,12,0.116,5.82
8477964,20192020,Ivan Barbashev,69,11,15,26,0.147,
8477964,20182019,Ivan Barbashev,80,14,12,26,0.2333,
8477964,20172018,Ivan Barbashev,53,7,6,13,0.1556,
8477964,20162017,Ivan Barbashev,30,5,7,12,0.25,
8478403,20242025,Jack Eichel,77,28,66,94,0.120172,26.32
8478403,20232024,Jack Eichel,63,31,37,68,0.111511,25.47
8478403,20222023,Jack Eichel,67,27,39,66,0.121076,20.71
8478403,20212022,Jack Eichel,34,14,11,25,0.105,11.21
8478403,20202021,Jack Eichel,21,2,16,18,0.033,6.21
8478403,20192020,Jack Eichel,68,36,42,78,0.159,
8478403,20182019,Jack Eichel,77,28,54,82,0.0924,
8478403,20172018,Jack Eichel,67,25,39,64,0.1016,
8478403,20162017,Jack Eichel,61,24,33,57,0.0964,
8478403,20152016,Jack Eichel,81,24,32,56,0.1008,
8476881,20242025,Tomas Hertl,73,32,29,61,0.180791,33.02
8476881,20232024,Tomas Hertl,6,2,2,4,0.181818,17.23
8476881,20222023,Tomas Hertl,79,22,41,63,0.120219,27.31
8476881,20212022,Tomas Hertl,82,30,34,64,0.146,29.02
8476881,20202021,Tomas Hertl,50,19,24,43,0.17,17.91
8476881,20192020,Tomas Hertl,48,16,20,36,0.137,
8476881,20182019,Tomas Hertl,77,35,39,74,0.1989,
8476881,20172018,Tomas Hertl,79,22,24,46,0.1257,
8476881,20162017,Tomas Hertl,49,10,12,22,0.1,
8476881,20152016,Tomas Hertl,81,21,25,46,0.104,
8476881,20142015,Tomas Hertl,82,13,18,31,0.0897,
8476881,20132014,Tomas Hertl,37,15,10,25,0.1531,
8479353,20242025,Brett Howden,80,23,17,40,0.184,19.84
8479353,20232024,Brett Howden,72,8,11,19,0.105263,10.36
8479353,20222023,Brett Howden,54,6,7,13,0.113208,7.88
8479353,20212022,Brett Howden,47,9,11,20,0.231,6.35
8479353,20202021,Brett Howden,42,1,6,7,0.03,4.93
8479353,20192020,Brett Howden,70,9,10,19,0.141,
8479353,20182019,Brett Howden,66,6,17,23,0.0811,
8476448,20242025,William Karlsson,53,9,20,29,0.07563,13.43
8476448,20232024,William Karlsson,70,30,30,60,0.171429,22.31
8476448,20222023,William Karlsson,82,14,39,53,0.086957,21.48
8476448,20212022,William Karlsson,67,12,23,35,0.089,15.33
8476448,20202021,William Karlsson,56,14,25,39,0.126,14.78
8476448,20192020,William Karlsson,63,15,31,46,0.109,
8476448,20182019,William Karlsson,82,24,32,56,0.142,
8476448,20172018,William Karlsson,82,43,35,78,0.2337,
8476448,20162017,William Karlsson,81,6,19,25,0.0625,
8476448,20152016,William Karlsson,81,9,11,20,0.0833,
8476448,20142015,William Karlsson,3,1,1,2,0.2,
8478434,20242025,Keegan Kolesar,82,12,18,30,0.136364,11.12
8478434,20232024,Keegan Kolesar,79,8,10,18,0.109589,7.36
8478434,20222023,Keegan Kolesar,74,8,10,18,0.126984,7.85
8478434,20212022,Keegan Kolesar,77,7,17,24,0.074,12.68
8478434,20202021,Keegan Kolesar,44,3,10,13,0.065,6.12
8478434,20192020,Keegan Kolesar,1,0,0,0,0.0,
8478483,20242025,Mitch Marner,81,27,75,102,0.156069,23.73
8478483,20232024,Mitch Marner,69,26,59,85,0.164557,21.85
8478483,20222023,Mitch Marner,80,30,69,99,0.153061,20.39
8478483,20212022,Mitch Marner,72,35,62,97,0.156,26.51
8478483,20202021,Mitch Marner,55,20,47,67,0.128,21.05
8478483,20192020,Mitch Marner,59,16,51,67,0.104,
8478483,20182019,Mitch Marner,82,26,68,94,0.1116,
8478483,20172018,Mitch Marner,82,22,47,69,0.1134,
8478483,20162017,Mitch Marner,77,19,42,61,0.108,
8476438,20242025,Brandon Saad,29,6,8,14,0.115385,15.89
8476438,20232024,Brandon Saad,82,26,16,42,0.180556,18.91
8476438,20222023,Brandon Saad,71,19,18,37,0.149606,16.21
8476438,20212022,Brandon Saad,78,24,25,49,0.152,20.75
8476438,20202021,Brandon Saad,44,15,9,24,0.221,8.62
8476438,20192020,Brandon Saad,58,21,12,33,0.15,
8476438,20182019,Brandon Saad,80,23,24,47,0.1179,
8476438,20172018,Brandon Saad,82,18,17,35,0.0759,
8476438,20162017,Brandon Saad,82,24,29,53,0.1143,
8476438,20152016,Brandon Saad,78,31,22,53,0.133,
8476438,20142015,Brandon Saad,82,23,29,52,0.1133,
8476438,20132014,Brandon Saad,78,19,28,47,0.1195,
8476438,20122013,Brandon Saad,46,10,17,27,0.102,
8476438,20112012,Brandon Saad,2,0,0,0,0.0,
8476925,20242025,Colton Sissons,72,7,14,21,0.0875,10.86
8476925,20232024,Colton Sissons,81,15,20,35,0.114504,20.86
8476925,20222023,Colton Sissons,82,12,18,30,0.137931,14.63
8476925,20212022,Colton Sissons,79,7,21,28,0.08,12.37
8476925,20202021,Colton Sissons,54,8,7,15,0.138,6.66
8476925,20192020,Colton Sissons,57,9,6,15,0.173,
8476925,20182019,Colton Sissons,75,15,15,30,0.1351,
8476925,20172018,Colton Sissons,81,9,18,27,0.075,
8476925,20162017,Colton Sissons,58,8,2,10,0.1905,
8476925,20152016,Colton Sissons,34,4,2,6,0.16,
8475191,20242025,Reilly Smith,21,3,8,11,0.075,17.18
8475191,20232024,Reilly Smith,76,13,27,40,0.085526,19.38
8475191,20222023,Reilly Smith,78,26,30,56,0.144444,22.47
8475191,20212022,Reilly Smith,56,16,22,38,0.107,18.73
8475191,20202021,Reilly Smith,53,14,11,25,0.113,15.51
8475191,20192020,Reilly Smith,71,27,27,54,0.16,
8475191,20182019,Reilly Smith,74,19,34,53,0.1067,
8475191,20172018,Reilly Smith,67,22,38,60,0.1358,
8475191,20162017,Reilly Smith,80,15,22,37,0.0938,
8475191,20152016,Reilly Smith,82,25,25,50,0.1445,
8475191,20142015,Reilly Smith,81,13,27,40,0.0909,
8475191,20132014,Reilly Smith,82,20,31,51,0.137,
8475191,20122013,Reilly Smith,37,3,6,9,0.0882,
8475191,20112012,Reilly Smith,3,0,0,0,0.0,
8475913,20242025,Mark Stone,66,19,48,67,0.145038,19.64
8475913,20232024,Mark Stone,56,16,37,53,0.136752,17.47
8475913,20222023,Mark Stone,43,17,21,38,0.150442,17.71
8475913,20212022,Mark Stone,37,9,21,30,0.127,11.04
8475913,20202021,Mark Stone,55,21,40,61,0.214,15.7
8475913,20192020,Mark Stone,65,21,42,63,0.125,
8475913,20182019,Mark Stone,18,5,6,11,0.0926,
8475913,20172018,Mark Stone,58,20,42,62,0.1515,
8475913,20162017,Mark Stone,71,22,32,54,0.1642,
8475913,20152016,Mark Stone,75,23,38,61,0.1523,
8475913,20142015,Mark Stone,80,26,38,64,0.1656,
8475913,20132014,Mark Stone,19,4,4,8,0.1111,
8475913,20122013,Mark Stone,4,0,0,0,0.0,
8479639,20242025,Dylan Coghlan,6,0,0,0,0.0,0.34
8479639,20232024,Dylan Coghlan,1,0,0,0,0.0,0.05
8479639,20222023,Dylan Coghlan,17,0,3,3,0.0,1.62
8479639,20212022,Dylan Coghlan,59,3,10,13,0.028,4.7
8479639,20202021,Dylan Coghlan,29,3,3,6,0.097,1.54
8478396,20242025,Noah Hanifin,80,10,29,39,0.068966,6.76
8478396,20232024,Noah Hanifin,19,2,10,12,0.04878,11.51
8478396,20222023,Noah Hanifin,81,7,31,38,0.039773,8.77
8478396,20212022,Noah Hanifin,81,10,38,48,0.053,8.4
8478396,20202021,Noah Hanifin,47,4,11,15,0.045,4.23
8478396,20192020,Noah Hanifin,70,5,17,22,0.038,
8478396,20182019,Noah Hanifin,80,5,28,33,0.0431,
8478396,20172018,Noah Hanifin,79,10,22,32,0.0606,
8478396,20162017,Noah Hanifin,81,4,25,29,0.037,
8478396,20152016,Noah Hanifin,79,4,18,22,0.0328,
8477018,20242025,Ben Hutton,11,0,2,2,0.0,0.39
8477018,20232024,Ben Hutton,41,2,8,10,0.029851,2.87
8477018,20222023,Ben Hutton,31,3,5,8,0.057692,2.64
8477018,20212022,Ben Hutton,58,3,10,13,0.038,2.58
8477018,20202021,Ben Hutton,4,0,0,0,0.0,2.12
8477018,20192020,Ben Hutton,65,4,12,16,0.035,
8477018,20182019,Ben Hutton,69,5,15,20,0.0439,
8477018,20172018,Ben Hutton,61,0,6,6,0.0,
8477018,20162017,Ben Hutton,71,5,14,19,0.0385,
8477018,20152016,Ben Hutton,75,1,24,25,0.0096,
8478468,20242025,Jeremy Lauzon,28,0,1,1,0.0,0.99
8478468,20232024,Jeremy Lauzon,79,6,8,14,0.058252,4.93
8478468,20222023,Jeremy Lauzon,67,3,9,12,0.038961,4.13
8478468,20212022,Jeremy Lauzon,13,1,0,1,0.059,2.87
8478468,20202021,Jeremy Lauzon,41,1,7,8,0.021,1.44
8478468,20192020,Jeremy Lauzon,19,1,1,2,0.05,
8478468,20182019,Jeremy Lauzon,16,1,0,1,0.0909,
8475188,20242025,Brayden McNabb,82,5,15,20,0.051546,3.73
8475188,20232024,Brayden McNabb,82,4,22,26,0.046512,3.71
8475188,20222023,Brayden McNabb,82,1,16,17,0.011236,3.97
8475188,20212022,Brayden McNabb,69,3,15,18,0.035,3.61
8475188,20202021,Brayden McNabb,41,2,6,8,0.051,1.87
8475188,20192020,Brayden McNabb,71,2,7,9,0.027,
8475188,20182019,Brayden McNabb,81,4,12,16,0.0476,
8475188,20172018,Brayden McNabb,76,5,10,15,0.0568,
8475188,20162017,Brayden McNabb,49,2,2,4,0.0426,
8475188,20152016,Brayden McNabb,81,2,12,14,0.022,
8475188,20142015,Brayden McNabb,71,2,22,24,0.027,
8475188,20132014,Brayden McNabb,12,0,0,0,0.0,
8477034,20242025,Jaycob Megna,8,0,0,0,0.0,0.19
8477034,20232024,Jaycob Megna,44,0,2,2,0.0,0.94
8477034,20222023,Jaycob Megna,6,0,0,0,0.0,2.69
8477034,20212022,Jaycob Megna,44,2,6,8,0.05,1.29
8477447,20242025,Shea Theodore,67,7,50,57,0.054688,7.36
8477447,20232024,Shea Theodore,47,5,37,42,0.047619,5.33
8477447,20222023,Shea Theodore,55,8,33,41,0.058824,7.24
8477447,20212022,Shea Theodore,78,14,38,52,0.068,11.33
8477447,20202021,Shea Theodore,53,8,34,42,0.05,7.08
8477447,20192020,Shea Theodore,71,13,33,46,0.059,
8477447,20182019,Shea Theodore,79,12,25,37,0.0594,
8477447,20172018,Shea Theodore,61,6,23,29,0.0417,
8477447,20162017,Shea Theodore,34,2,7,9,0.0333,
8477447,20152016,Shea Theodore,19,3,5,8,0.1071,
8480727,20242025,Zach Whitecloud,74,4,9,13,0.055556,3.12
8480727,20232024,Zach Whitecloud,61,2,12,14,0.039216,2.25
8480727,20222023,Zach Whitecloud,59,5,7,12,0.078125,3.52
8480727,20212022,Zach Whitecloud,59,8,11,19,0.085,4.18
8480727,20202021,Zach Whitecloud,51,2,10,12,0.037,3.2
8480727,20192020,Zach Whitecloud,16,0,1,1,0.0,
8479994,20242025,Jaret Anderson-Dolan,7,0,1,1,0.0,0.62
8479994,20232024,Jaret Anderson-Dolan,1,0,0,0,0.0,3.48
8479994,20222023,Jaret Anderson-Dolan,46,7,5,12,0.12963,5.21
8479994,20212022,Jaret Anderson-Dolan,7,0,0,0,0.0,0.57
8479994,20202021,Jaret Anderson-Dolan,34,7,4,11,0.189,3.13
8479994,20192020,Jaret Anderson-Dolan,4,0,0,0,0.0,
8479994,20182019,Jaret Anderson-Dolan,5,0,1,1,0.0,
8480289,20242025,Morgan Barron,74,8,7,15,0.086957,12.25
8480289,20232024,Morgan Barron,80,11,7,18,0.117021,9.13
8480289,20222023,Morgan Barron,70,8,13,21,0.071429,13.89
8480289,20212022,Morgan Barron,14,2,2,4,0.083,2.76
8480289,20202021,Morgan Barron,5,1,0,1,0.333,0.08
8478398,20242025,Kyle Connor,82,41,56,97,0.153558,30.19
8478398,20232024,Kyle Connor,65,34,27,61,0.153846,21.53
8478398,20222023,Kyle Connor,82,31,49,80,0.113553,33.07
8478398,20212022,Kyle Connor,79,47,46,93,0.148,35.14
8478398,20202021,Kyle Connor,56,26,24,50,0.157,17.75
8478398,20192020,Kyle Connor,71,38,35,73,0.159,
8478398,20182019,Kyle Connor,82,34,32,66,0.1498,
8478398,20172018,Kyle Connor,76,31,26,57,0.1615,
8478398,20162017,Kyle Connor,20,2,3,5,0.0833,
8476858,20242025,Phillip Di Giuseppe,20,1,5,6,0.043478,1.88
8476858,20232024,Phillip Di Giuseppe,51,5,5,10,0.096154,6.13
8476858,20222023,Phillip Di Giuseppe,30,6,6,12,0.084507,6.79
8481019,20242025,David Gustafsson,36,2,4,6,0.066667,3.94
8481019,20232024,David Gustafsson,39,3,4,7,0.111111,2.69
8481019,20222023,David Gustafsson,46,0,6,6,0.0,3.98
8481019,20212022,David Gustafsson,2,0,0,0,0.0,0
8481019,20202021,David Gustafsson,4,0,0,0,0.0,0.03
8481019,20192020,David Gustafsson,22,1,0,1,0.25,
8480113,20242025,Alex Iafallo,82,15,16,31,0.137615,14.49
8480113,20232024,Alex Iafallo,82,11,16,27,0.091667,15.11
8480113,20222023,Alex Iafallo,59,14,22,36,0.105263,14.72
8480113,20212022,Alex Iafallo,79,17,20,37,0.079,22.26
8480113,20202021,Alex Iafallo,55,13,17,30,0.11,14.18
8480113,20192020,Alex Iafallo,70,17,26,43,0.12,
8480113,20182019,Alex Iafallo,82,15,18,33,0.1014,
8480113,20172018,Alex Iafallo,75,9,16,25,0.0698,
8476392,20242025,Adam Lowry,73,16,18,34,0.161616,17.19
8476392,20232024,Adam Lowry,81,12,23,35,0.10084,21.07
8476392,20222023,Adam Lowry,82,13,23,36,0.103175,19.91
8476392,20212022,Adam Lowry,79,13,8,21,0.113,18.35
8476392,20202021,Adam Lowry,52,10,14,24,0.125,10.11
8476392,20192020,Adam Lowry,49,4,6,10,0.059,
8476392,20182019,Adam Lowry,78,12,11,23,0.1143,
8476392,20172018,Adam Lowry,45,8,13,21,0.1143,
8476392,20162017,Adam Lowry,82,15,14,29,0.123,
8476392,20152016,Adam Lowry,74,7,10,17,0.0959,
8476392,20142015,Adam Lowry,80,11,12,23,0.1058,
8476480,20242025,Vladislav Namestnikov,78,11,27,38,0.117021,17.23
8476480,20232024,Vladislav Namestnikov,78,11,26,37,0.115789,13.67
8476480,20222023,Vladislav Namestnikov,20,2,8,10,0.055556,14.56
8476480,20212022,Vladislav Namestnikov,15,3,2,5,0.3,14.45
8476480,20202021,Vladislav Namestnikov,53,8,9,17,0.092,12.68
8476480,20192020,Vladislav Namestnikov,9,4,2,6,0.4,
8476480,20182019,Vladislav Namestnikov,78,11,20,31,0.0924,
8476480,20172018,Vladislav Namestnikov,19,2,2,4,0.0714,
8476480,20162017,Vladislav Namestnikov,74,10,18,28,0.0877,
8476480,20152016,Vladislav Namestnikov,80,14,21,35,0.1321,
8476480,20142015,Vladislav Namestnikov,43,9,7,16,0.1957,
8476480,20132014,Vladislav Namestnikov,4,0,0,0,0.0,
8475799,20242025,Nino Niederreiter,82,17,20,37,0.113333,22.39
8475799,20232024,Nino Niederreiter,77,18,16,34,0.105882,22.54
8475799,20222023,Nino Niederreiter,22,6,7,13,0.117647,24.46
8475799,20212022,Nino Niederreiter,75,24,20,44,0.167,23.55
8475799,20202021,Nino Niederreiter,56,20,14,34,0.159,17.99
8475799,20192020,Nino Niederreiter,67,11,18,29,0.096,
8475799,20182019,Nino Niederreiter,36,14,16,30,0.1359,
8475799,20172018,Nino Niederreiter,63,18,14,32,0.1353,
8475799,20162017,Nino Niederreiter,82,25,32,57,0.1344,
8475799,20152016,Nino Niederreiter,82,20,23,43,0.1258,
8475799,20142015,Nino Niederreiter,80,24,13,37,0.1611,
8475799,20132014,Nino Niederreiter,81,14,22,36,0.0979,
8474679,20242025,Gustav Nyquist,22,2,5,7,0.0625,16.51
8474679,20232024,Gustav Nyquist,81,23,52,75,0.150327,21.29
8474679,20222023,Gustav Nyquist,3,1,4,5,0.2,13.69
8474679,20212022,Gustav Nyquist,82,18,35,53,0.148,17.41
8476871,20242025,Tanner Pearson,78,12,15,27,0.110092,14.31
8476871,20232024,Tanner Pearson,54,5,8,13,0.064935,9.23
8476871,20222023,Tanner Pearson,14,1,4,5,0.058824,1.91
8476871,20212022,Tanner Pearson,68,14,20,34,0.088,16.43
8476871,20202021,Tanner Pearson,51,10,8,18,0.091,13.32
8476871,20192020,Tanner Pearson,69,21,24,45,0.128,
8476871,20182019,Tanner Pearson,19,9,3,12,0.2143,
8476871,20172018,Tanner Pearson,82,15,25,40,0.0833,
8476871,20162017,Tanner Pearson,80,24,20,44,0.1283,
8476871,20152016,Tanner Pearson,79,15,21,36,0.1095,
8476871,20142015,Tanner Pearson,42,12,4,16,0.1765,
8476871,20132014,Tanner Pearson,25,3,4,7,0.0968,
8476460,20242025,Mark Scheifele,82,39,48,87,0.21547,28.83
8476460,20232024,Mark Scheifele,74,25,47,72,0.162338,22.56
8476460,20222023,Mark Scheifele,81,42,26,68,0.203883,32.69
8476460,20212022,Mark Scheifele,67,29,41,70,0.182,20.43
8476460,20202021,Mark Scheifele,56,21,42,63,0.167,16.07
8476460,20192020,Mark Scheifele,71,29,44,73,0.171,
8476460,20182019,Mark Scheifele,82,38,46,84,0.191,
8476460,20172018,Mark Scheifele,60,23,37,60,0.184,
8476460,20162017,Mark Scheifele,79,32,50,82,0.2,
8476460,20152016,Mark Scheifele,71,29,32,61,0.1495,
8476460,20142015,Mark Scheifele,82,15,34,49,0.0882,
8476460,20132014,Mark Scheifele,63,13,21,34,0.13,
8476460,20122013,Mark Scheifele,4,0,0,0,0.0,
8476460,20112012,Mark Scheifele,7,1,0,1,0.2,
8480014,20242025,Gabriel Vilardi,71,27,34,61,0.207692,21.67
8480014,20232024,Gabriel Vilardi,47,22,14,36,0.188034,18.56
8480014,20222023,Gabriel Vilardi,63,23,18,41,0.188525,17.5
8480014,20212022,Gabriel Vilardi,25,5,2,7,0.122,4.15
8480014,20202021,Gabriel Vilardi,54,10,13,23,0.154,9.03
8480014,20192020,Gabriel Vilardi,10,3,4,7,0.158,
8476331,20242025,Dylan DeMelo,82,3,16,19,0.04,3.01
8476331,20232024,Dylan DeMelo,82,3,28,31,0.036145,3.15
8476331,20222023,Dylan DeMelo,75,6,21,27,0.064516,5.21
8476331,20212022,Dylan DeMelo,76,1,12,13,0.013,3.48
8476331,20202021,Dylan DeMelo,52,0,9,9,0.0,1.84
8476331,20192020,Dylan DeMelo,10,0,0,0,0.0,
8476331,20182019,Dylan DeMelo,77,4,18,22,0.0367,
8476331,20172018,Dylan DeMelo,63,0,20,20,0.0,
8476331,20162017,Dylan DeMelo,25,1,7,8,0.0313,
8476331,20152016,Dylan DeMelo,45,2,2,4,0.0476,
8477938,20242025,Haydn Fleury,39,0,7,7,0.0,1.23
8477938,20232024,Haydn Fleury,24,1,4,5,0.04,1.33
8477938,20222023,Haydn Fleury,29,0,1,1,0.0,1.92
8477938,20212022,Haydn Fleury,36,2,2,4,0.038,2.81
8477938,20202021,Haydn Fleury,12,2,1,3,0.143,2.11
8477938,20192020,Haydn Fleury,45,4,10,14,0.062,
8477938,20182019,Haydn Fleury,20,0,1,1,0.0,
8477938,20172018,Haydn Fleury,67,0,8,8,0.0,
8481572,20242025,Ville Heinola,18,0,1,1,0.0,0.48
8476525,20242025,Colin Miller,60,4,11,15,0.058824,2.92
8476525,20232024,Colin Miller,5,0,1,1,0.0,2.02
8476525,20222023,Colin Miller,79,6,15,21,0.056604,5.03
8476525,20212022,Colin Miller,38,2,12,14,0.042,1.36
8476525,20202021,Colin Miller,48,4,8,12,0.063,2.47
8476525,20192020,Colin Miller,51,1,10,11,0.013,
8476525,20182019,Colin Miller,65,3,26,29,0.0229,
8476525,20172018,Colin Miller,82,10,31,41,0.0565,
8476525,20162017,Colin Miller,61,6,7,13,0.0706,
8476525,20152016,Colin Miller,42,3,13,16,0.0508,
8477504,20242025,Josh Morrissey,80,14,48,62,0.081395,9.89
8477504,20232024,Josh Morrissey,81,10,59,69,0.05102,11.02
8477504,20222023,Josh Morrissey,78,16,60,76,0.093023,11.25
8477504,20212022,Josh Morrissey,79,12,25,37,0.069,11.57
8477504,20202021,Josh Morrissey,56,4,17,21,0.034,4.83
8477504,20192020,Josh Morrissey,65,5,26,31,0.042,
8477504,20182019,Josh Morrissey,59,6,25,31,0.0632,
8477504,20172018,Josh Morrissey,81,7,19,26,0.0686,
8477504,20162017,Josh Morrissey,82,6,14,20,0.0606,
8477504,20152016,Josh Morrissey,1,0,0,0,0.0,
8480145,20242025,Neal Pionk,69,10,29,39,0.081301,5.26
8480145,20232024,Neal Pionk,82,5,28,33,0.034247,6.1
8480145,20222023,Neal Pionk,82,10,23,33,0.070423,7
8480145,20212022,Neal Pionk,77,3,31,34,0.021,5.97
8480145,20202021,Neal Pionk,54,3,29,32,0.03,3.98
8480145,20192020,Neal Pionk,71,6,39,45,0.034,
8480145,20182019,Neal Pionk,73,6,20,26,0.0455,
8480145,20172018,Neal Pionk,28,1,13,14,0.0185,
8474568,20242025,Luke Schenn,15,0,2,2,0.0,4.08
8474568,20232024,Luke Schenn,63,1,6,7,0.012346,2.33
8474568,20222023,Luke Schenn,15,1,0,1,0.076923,2.77
8474568,20212022,Luke Schenn,66,5,12,17,0.064,3.47
8474568,20202021,Luke Schenn,38,2,2,4,0.047,1.68
8474568,20192020,Luke Schenn,25,1,2,3,0.032,
8474568,20182019,Luke Schenn,18,0,2,2,0.0,
8474568,20172018,Luke Schenn,64,1,6,7,0.0169,
8474568,20162017,Luke Schenn,78,1,7,8,0.0106,
8474568,20152016,Luke Schenn,43,2,9,11,0.0351,
8474568,20142015,Luke Schenn,58,3,11,14,0.0448,
8474568,20132014,Luke Schenn,79,4,8,12,0.0513,
8474568,20122013,Luke Schenn,47,3,8,11,0.037,
8474568,20112012,Luke Schenn,79,2,20,22,0.0247,
8474568,20102011,Luke Schenn,82,5,17,22,0.0391,
8474568,20092010,Luke Schenn,79,5,12,17,0.0495,
8474568,20082009,Luke Schenn,70,2,12,14,0.0196,
8479378,20242025,Logan Stanley,63,1,13,14,0.020408,1.74
8479378,20232024,Logan Stanley,25,1,1,2,0.034483,0.86
8479378,20222023,Logan Stanley,19,1,2,3,0.090909,0.52
8479378,20212022,Logan Stanley,58,1,12,13,0.013,2.98
8479378,20202021,Logan Stanley,37,1,3,4,0.016,1.98
8478463,20242025,Anthony Beauvillier,18,2,3,5,0.068966,19.42
8478463,20232024,Anthony Beauvillier,15,1,2,3,0.03125,11.56
8478463,20222023,Anthony Beauvillier,33,9,11,20,0.142857,18.67
8478463,20212022,Anthony Beauvillier,75,12,22,34,0.078,16.05
8478463,20202021,Anthony Beauvillier,47,15,13,28,0.138,10.8
8478463,20192020,Anthony Beauvillier,68,18,21,39,0.136,
8478463,20182019,Anthony Beauvillier,81,18,10,28,0.1154,
8478463,20172018,Anthony Beauvillier,71,21,15,36,0.1591,
8478463,20162017,Anthony Beauvillier,66,9,15,24,0.0891,
8475343,20242025,Nic Dowd,82,14,13,27,0.162791,13.92
8475343,20232024,Nic Dowd,64,12,10,22,0.196721,8.95
8475343,20222023,Nic Dowd,65,13,12,25,0.209677,7.84
8475343,20212022,Nic Dowd,64,10,14,24,0.111,9.61
8475343,20202021,Nic Dowd,56,11,4,15,0.162,8.9
8475343,20192020,Nic Dowd,56,7,8,15,0.135,
8475343,20182019,Nic Dowd,64,8,14,22,0.1702,
8475343,20172018,Nic Dowd,40,3,0,3,0.075,
8475343,20162017,Nic Dowd,70,6,16,22,0.0769,
8475343,20152016,Nic Dowd,5,0,0,0,0.0,
8479400,20242025,Pierre-Luc Dubois,82,20,46,66,0.140845,22.91
8479400,20232024,Pierre-Luc Dubois,82,16,24,40,0.109589,21.51
8479400,20222023,Pierre-Luc Dubois,73,27,36,63,0.131707,29.91
8479400,20212022,Pierre-Luc Dubois,81,28,32,60,0.12,35.25
8479400,20202021,Pierre-Luc Dubois,41,8,12,20,0.116,6.14
8479400,20192020,Pierre-Luc Dubois,70,18,31,49,0.114,
8479400,20182019,Pierre-Luc Dubois,82,27,34,61,0.1552,
8479400,20172018,Pierre-Luc Dubois,82,20,28,48,0.1212,
8481580,20242025,Connor McMichael,82,26,31,57,0.146893,26.65
8481580,20232024,Connor McMichael,80,18,15,33,0.133333,20.7
8481580,20222023,Connor McMichael,6,0,0,0,0.0,0.16
8481580,20212022,Connor McMichael,68,9,9,18,0.086,11.5
8481580,20202021,Connor McMichael,1,0,0,0,0.0,0.09
8477947,20242025,Sonny Milano,3,0,0,0,0.0,0.38
8477947,20232024,Sonny Milano,49,15,8,23,0.3,5.68
8477947,20222023,Sonny Milano,64,11,22,33,0.1375,11.79
8477947,20212022,Sonny Milano,66,14,20,34,0.149,12.87
8477947,20202021,Sonny Milano,6,0,0,0,0.0,0.71
8477947,20192020,Sonny Milano,9,2,3,5,0.182,
8477947,20182019,Sonny Milano,8,1,0,1,0.2,
8477947,20172018,Sonny Milano,55,14,8,22,0.2029,
8477947,20162017,Sonny Milano,4,0,0,0,0.0,
8477947,20152016,Sonny Milano,3,0,1,1,0.0,
8471214,20242025,Alex Ovechkin,65,44,29,73,0.185654,31.07
8471214,20232024,Alex Ovechkin,79,31,34,65,0.113971,30.54
8471214,20222023,Alex Ovechkin,73,42,33,75,0.142857,37.37
8471214,20212022,Alex Ovechkin,77,50,40,90,0.15,36.37
8471214,20202021,Alex Ovechkin,45,24,18,42,0.132,17.8
8471214,20192020,Alex Ovechkin,68,48,19,67,0.154,
8471214,20182019,Alex Ovechkin,81,51,38,89,0.1509,
8471214,20172018,Alex Ovechkin,82,49,38,87,0.138,
8471214,20162017,Alex Ovechkin,82,33,36,69,0.1054,
8471214,20152016,Alex Ovechkin,79,50,21,71,0.1256,
8471214,20142015,Alex Ovechkin,81,53,28,81,0.1342,
8471214,20132014,Alex Ovechkin,78,51,28,79,0.1321,
8471214,20122013,Alex Ovechkin,48,32,24,56,0.1455,
8471214,20112012,Alex Ovechkin,78,38,27,65,0.1254,
8471214,20102011,Alex Ovechkin,79,32,53,85,0.0872,
8471214,20092010,Alex Ovechkin,72,50,59,109,0.1359,
8471214,20082009,Alex Ovechkin,79,56,54,110,0.1061,
8471214,20072008,Alex Ovechkin,82,65,47,112,0.1457,
8471214,20062007,Alex Ovechkin,82,46,46,92,0.1173,
8471214,20052006,Alex Ovechkin,81,52,54,106,0.1224,
8478440,20242025,Dylan Strome,82,29,53,82,0.194631,20.86
8478440,20232024,Dylan Strome,82,27,40,67,0.159763,23.05
8478440,20222023,Dylan Strome,81,23,42,65,0.149351,22.11
8478440,20212022,Dylan Strome,69,22,26,48,0.175,15.46
8478440,20202021,Dylan Strome,40,9,8,17,0.127,7.61
8478440,20192020,Dylan Strome,58,12,26,38,0.124,
8478440,20182019,Dylan Strome,58,17,34,51,0.1619,
8478440,20172018,Dylan Strome,21,4,5,9,0.1333,
8478440,20162017,Dylan Strome,7,0,1,1,0.0,
8476880,20242025,Tom Wilson,81,33,32,65,0.195266,28.96
8476880,20232024,Tom Wilson,74,18,17,35,0.106509,23.96
8476880,20222023,Tom Wilson,33,13,9,22,0.158537,10.48
8476880,20212022,Tom Wilson,78,24,28,52,0.159,19.41
8476880,20202021,Tom Wilson,47,13,20,33,0.157,9.68
8476880,20192020,Tom Wilson,68,21,23,44,0.136,
8476880,20182019,Tom Wilson,63,22,18,40,0.1692,
8476880,20172018,Tom Wilson,78,14,21,35,0.1138,
8476880,20162017,Tom Wilson,82,7,12,19,0.0737,
8476880,20152016,Tom Wilson,82,7,16,23,0.0707,
8476880,20142015,Tom Wilson,67,4,13,17,0.0506,
8476880,20132014,Tom Wilson,82,3,7,10,0.0476,
8474590,20242025,John Carlson,79,5,46,51,0.02994,9.48
8474590,20232024,John Carlson,82,10,42,52,0.056818,10.75
8474590,20222023,John Carlson,40,9,20,29,0.072581,8.43
8474590,20212022,John Carlson,78,17,54,71,0.087,11.71
8474590,20202021,John Carlson,52,10,34,44,0.078,6.35
8474590,20192020,John Carlson,69,15,60,75,0.079,
8474590,20182019,John Carlson,80,13,57,70,0.0703,
8474590,20172018,John Carlson,82,15,53,68,0.0633,
8474590,20162017,John Carlson,72,9,28,37,0.05,
8474590,20152016,John Carlson,56,8,31,39,0.0645,
8474590,20142015,John Carlson,82,12,43,55,0.0622,
8474590,20132014,John Carlson,82,10,27,37,0.0481,
8474590,20122013,John Carlson,48,6,16,22,0.0619,
8474590,20112012,John Carlson,82,9,23,32,0.0592,
8474590,20102011,John Carlson,82,7,30,37,0.0486,
8474590,20092010,John Carlson,22,1,5,6,0.0476,
8479345,20242025,Jakob Chychrun,74,20,27,47,0.111732,12.44
8479345,20232024,Jakob Chychrun,82,14,27,41,0.068627,12.93
8479345,20222023,Jakob Chychrun,12,2,3,5,0.066667,11.51
8479345,20212022,Jakob Chychrun,47,7,14,21,0.05,6.72
8479345,20202021,Jakob Chychrun,56,18,23,41,0.102,9.06
8479345,20192020,Jakob Chychrun,63,12,14,26,0.081,
8479345,20182019,Jakob Chychrun,53,5,15,20,0.0427,
8479345,20172018,Jakob Chychrun,50,4,10,14,0.0392,
8479345,20162017,Jakob Chychrun,68,7,13,20,0.0814,
8480796,20242025,Martin Fehérváry,81,5,20,25,0.065789,3.95
8480796,20232024,Martin Fehérváry,66,3,13,16,0.04918,2.9
8480796,20222023,Martin Fehérváry,67,6,10,16,0.065934,6.52
8480796,20212022,Martin Fehérváry,79,8,9,17,0.083,4.41
8475795,20242025,Dylan McIlrath,17,0,2,2,0.0,0.5
8475795,20232024,Dylan McIlrath,3,0,1,1,0.0,0.05
8475795,20222023,Dylan McIlrath,6,0,1,1,0.0,0.23
8478911,20242025,Matt Roy,69,3,21,24,0.035714,4.62
8478911,20232024,Matt Roy,81,5,20,25,0.037037,7.41
8478911,20222023,Matt Roy,82,9,17,26,0.066667,7.4
8478911,20212022,Matt Roy,67,2,19,21,0.013,6.25
8478911,20202021,Matt Roy,44,2,8,10,0.035,2.55
8478911,20192020,Matt Roy,70,4,14,18,0.036,
8478911,20182019,Matt Roy,25,2,4,6,0.0588,
8480873,20242025,Rasmus Sandin,82,4,26,30,0.051282,5.55
8480873,20232024,Rasmus Sandin,68,3,20,23,0.037975,4.37
8480873,20222023,Rasmus Sandin,19,3,12,15,0.130435,3.63
8480873,20212022,Rasmus Sandin,51,5,11,16,0.109,3.09
8480873,20202021,Rasmus Sandin,9,0,4,4,0.0,0.28
8480873,20192020,Rasmus Sandin,28,1,7,8,0.045,
8477845,20242025,Trevor van Riemsdyk,82,1,20,21,0.0125,3.29
8477845,20232024,Trevor van Riemsdyk,70,0,14,14,0.0,2.58
8477845,20222023,Trevor van Riemsdyk,75,7,16,23,0.072165,4
8477845,20212022,Trevor van Riemsdyk,72,1,16,17,0.013,2.97
8477845,20202021,Trevor van Riemsdyk,20,1,2,3,0.043,0.49
8477845,20192020,Trevor van Riemsdyk,49,1,7,8,0.017,
8477845,20182019,Trevor van Riemsdyk,78,3,11,14,0.0294,
8477845,20172018,Trevor van Riemsdyk,79,3,13,16,0.027,
8477845,20162017,Trevor van Riemsdyk,58,5,11,16,0.0685,
8477845,20152016,Trevor van Riemsdyk,82,3,11,14,0.0353,
8477845,20142015,Trevor van Riemsdyk,18,0,1,1,0.0,
