gp,goals,assists,points,shp,xg,season,id,name
31,7,14,21,0.162791,5.73,20242025,8475798,Mikael Granlund
69,12,48,60,0.089552,5.79,20232024,8475798,Mikael Granlund
21,1,4,5,0.026316,7.4,20222023,8475798,Mikael Granlund
80,11,53,64,0.094,0.2,20212022,8475798,Mikael Granlund
51,13,14,27,0.176,0.41,20202021,8475798,Mikael Granlund
63,17,13,30,0.131,,20192020,8475798,Mikael Granlund
16,1,4,5,0.0345,,20182019,8475798,Mikael Granlund
77,21,46,67,0.1088,,20172018,8475798,Mikael Granlund
81,26,43,69,0.1469,,20162017,8475798,Mikael Granlund
82,13,31,44,0.0813,,20152016,8475798,Mikael Granlund
68,8,31,39,0.0808,,20142015,8475798,Mikael Granlund
63,8,33,41,0.0769,,20132014,8475798,Mikael Granlund
27,2,6,8,0.0556,,20122013,8475798,Mikael Granlund
62,2,4,6,0.040816,5.73,20242025,8478424,Jansen Harkins
45,0,4,4,0.0,5.79,20232024,8478424,Jansen Harkins
22,3,2,5,0.166667,7.4,20222023,8478424,Jansen Harkins
77,7,6,13,0.104,0.2,20212022,8478424,Jansen Harkins
26,1,1,2,0.063,0.41,20202021,8478424,Jansen Harkins
29,2,5,7,0.069,,20192020,8478424,Jansen Harkins
43,1,3,4,0.111111,5.73,20242025,8477527,Ross Johnston
68,1,3,4,0.022727,5.79,20232024,8477527,Ross Johnston
16,0,2,2,0.0,7.4,20222023,8477527,Ross Johnston
32,2,5,7,0.222,0.2,20212022,8477527,Ross Johnston
12,0,1,1,0.0,0.41,20202021,8477527,Ross Johnston
32,3,1,4,0.188,,20192020,8477527,Ross Johnston
17,1,3,4,0.0833,,20182019,8477527,Ross Johnston
24,3,3,6,0.1579,,20172018,8477527,Ross Johnston
82,19,18,37,0.141791,5.73,20242025,8473986,Alex Killorn
63,18,18,36,0.124138,5.79,20232024,8473986,Alex Killorn
82,27,37,64,0.188811,7.4,20222023,8473986,Alex Killorn
82,25,34,59,0.152,0.2,20212022,8473986,Alex Killorn
56,15,18,33,0.124,0.41,20202021,8473986,Alex Killorn
68,26,23,49,0.2,,20192020,8473986,Alex Killorn
82,18,22,40,0.1176,,20182019,8473986,Alex Killorn
82,15,32,47,0.0962,,20172018,8473986,Alex Killorn
81,19,17,36,0.108,,20162017,8473986,Alex Killorn
81,14,26,40,0.0909,,20152016,8473986,Alex Killorn
71,15,23,38,0.1154,,20142015,8473986,Alex Killorn
82,17,24,41,0.0983,,20132014,8473986,Alex Killorn
38,7,12,19,0.0854,,20122013,8473986,Alex Killorn
68,22,8,30,0.144737,5.73,20242025,8475184,Chris Kreider
82,39,36,75,0.158537,5.79,20232024,8475184,Chris Kreider
79,36,18,54,0.157205,7.4,20222023,8475184,Chris Kreider
81,52,25,77,0.202,0.2,20212022,8475184,Chris Kreider
50,20,10,30,0.196,0.41,20202021,8475184,Chris Kreider
63,24,21,45,0.154,,20192020,8475184,Chris Kreider
79,28,24,52,0.1393,,20182019,8475184,Chris Kreider
58,16,21,37,0.1168,,20172018,8475184,Chris Kreider
75,28,25,53,0.1505,,20162017,8475184,Chris Kreider
79,21,22,43,0.1329,,20152016,8475184,Chris Kreider
80,21,25,46,0.1167,,20142015,8475184,Chris Kreider
66,17,20,37,0.125,,20132014,8475184,Chris Kreider
23,2,1,3,0.1053,,20122013,8475184,Chris Kreider
68,12,19,31,0.169014,5.73,20242025,8480068,Ryan Poehling
77,11,17,28,0.099099,5.79,20232024,8480068,Ryan Poehling
53,7,7,14,0.109375,7.4,20222023,8480068,Ryan Poehling
57,9,8,17,0.099,0.2,20212022,8480068,Ryan Poehling
82,10,31,41,0.072993,5.73,20242025,8476458,Ryan Strome
79,11,30,41,0.083969,5.79,20232024,8476458,Ryan Strome
82,15,26,41,0.115385,7.4,20222023,8476458,Ryan Strome
74,21,33,54,0.13,0.2,20212022,8476458,Ryan Strome
56,14,35,49,0.109,0.41,20202021,8476458,Ryan Strome
70,18,41,59,0.117,,20192020,8476458,Ryan Strome
63,18,15,33,0.225,,20182019,8476458,Ryan Strome
82,13,21,34,0.0884,,20172018,8476458,Ryan Strome
69,13,17,30,0.114,,20162017,8476458,Ryan Strome
71,8,20,28,0.0606,,20152016,8476458,Ryan Strome
81,17,33,50,0.095,,20142015,8476458,Ryan Strome
37,7,11,18,0.0787,,20132014,8476458,Ryan Strome
77,21,34,55,0.111702,5.73,20242025,8478873,Troy Terry
76,20,34,54,0.116279,5.79,20232024,8478873,Troy Terry
70,23,38,61,0.12234,7.4,20222023,8478873,Troy Terry
75,37,30,67,0.193,0.2,20212022,8478873,Troy Terry
48,7,13,20,0.101,0.41,20202021,8478873,Troy Terry
47,4,11,15,0.055,,20192020,8478873,Troy Terry
32,4,9,13,0.16,,20182019,8478873,Troy Terry
2,0,0,0,0.0,,20172018,8478873,Troy Terry
81,21,24,45,0.089744,5.73,20242025,8478366,Frank Vatrano
82,37,23,60,0.136029,5.79,20232024,8478366,Frank Vatrano
81,22,19,41,0.095238,7.4,20222023,8478366,Frank Vatrano
22,8,5,13,0.143,0.2,20212022,8478366,Frank Vatrano
56,18,8,26,0.114,0.41,20202021,8478366,Frank Vatrano
69,16,18,34,0.099,,20192020,8478366,Frank Vatrano
81,24,15,39,0.1154,,20182019,8478366,Frank Vatrano
16,5,3,8,0.1667,,20172018,8478366,Frank Vatrano
44,10,8,18,0.0862,,20162017,8478366,Frank Vatrano
39,8,3,11,0.0808,,20152016,8478366,Frank Vatrano
81,1,15,16,0.011236,5.73,20242025,8475462,Radko Gudas
66,6,12,18,0.068182,5.79,20232024,8475462,Radko Gudas
72,2,15,17,0.018182,7.4,20222023,8475462,Radko Gudas
77,3,13,16,0.03,0.2,20212022,8475462,Radko Gudas
54,2,9,11,0.024,0.41,20202021,8475462,Radko Gudas
63,2,13,15,0.022,,20192020,8475462,Radko Gudas
77,4,16,20,0.0294,,20182019,8475462,Radko Gudas
70,2,14,16,0.0141,,20172018,8475462,Radko Gudas
67,6,17,23,0.0531,,20162017,8475462,Radko Gudas
76,5,9,14,0.0333,,20152016,8475462,Radko Gudas
31,2,3,5,0.0317,,20142015,8475462,Radko Gudas
73,3,19,22,0.0263,,20132014,8475462,Radko Gudas
22,2,3,5,0.0645,,20122013,8475462,Radko Gudas
53,1,7,8,0.015385,5.73,20242025,8476885,Jacob Trouba
69,3,19,22,0.023256,5.79,20232024,8476885,Jacob Trouba
82,8,22,30,0.040201,7.4,20222023,8476885,Jacob Trouba
81,11,28,39,0.054,0.2,20212022,8476885,Jacob Trouba
38,2,10,12,0.029,0.41,20202021,8476885,Jacob Trouba
70,7,20,27,0.042,,20192020,8476885,Jacob Trouba
82,8,42,50,0.0494,,20182019,8476885,Jacob Trouba
55,3,21,24,0.0208,,20172018,8476885,Jacob Trouba
60,8,25,33,0.0519,,20162017,8476885,Jacob Trouba
81,6,15,21,0.0451,,20152016,8476885,Jacob Trouba
65,7,15,22,0.0526,,20142015,8476885,Jacob Trouba
65,10,19,29,0.0826,,20132014,8476885,Jacob Trouba
67,15,12,27,0.094937,5.73,20242025,8478042,Viktor Arvidsson
18,6,9,15,0.101695,5.79,20232024,8478042,Viktor Arvidsson
77,26,33,59,0.114035,7.4,20222023,8478042,Viktor Arvidsson
66,20,29,49,0.088,0.2,20212022,8478042,Viktor Arvidsson
50,10,15,25,0.066,0.41,20202021,8478042,Viktor Arvidsson
57,15,13,28,0.118,,20192020,8478042,Viktor Arvidsson
58,34,14,48,0.1744,,20182019,8478042,Viktor Arvidsson
78,29,32,61,0.1174,,20172018,8478042,Viktor Arvidsson
80,31,30,61,0.126,,20162017,8478042,Viktor Arvidsson
56,8,8,16,0.0576,,20152016,8478042,Viktor Arvidsson
6,0,0,0,0.0,,20142015,8478042,Viktor Arvidsson
15,0,1,1,0.0,5.73,20242025,8477887,Patrick Brown
11,0,1,1,0.0,5.79,20232024,8477887,Patrick Brown
18,2,3,5,0.125,7.4,20222023,8477887,Patrick Brown
44,4,5,9,0.078,0.2,20212022,8477887,Patrick Brown
4,0,0,0,0.0,0.41,20202021,8477887,Patrick Brown
1,1,0,1,0.5,,20192020,8477887,Patrick Brown
77,33,24,57,0.22,5.73,20242025,8479987,Morgan Geekie
76,17,22,39,0.130769,5.79,20232024,8479987,Morgan Geekie
69,9,19,28,0.111111,7.4,20222023,8479987,Morgan Geekie
73,7,15,22,0.072,0.2,20212022,8479987,Morgan Geekie
36,3,6,9,0.1,0.41,20202021,8479987,Morgan Geekie
2,3,1,4,0.75,,20192020,8479987,Morgan Geekie
67,7,6,13,0.125,5.73,20242025,8479661,Tanner Jeannot
55,7,7,14,0.118644,5.79,20232024,8479661,Tanner Jeannot
20,1,3,4,0.05,7.4,20222023,8479661,Tanner Jeannot
81,24,17,41,0.194,0.2,20212022,8479661,Tanner Jeannot
15,5,2,7,0.217,0.41,20202021,8479661,Tanner Jeannot
82,6,11,17,0.068182,5.73,20242025,8476374,Sean Kuraly
62,9,9,18,0.097826,5.79,20232024,8476374,Sean Kuraly
71,11,9,20,0.11,7.4,20222023,8476374,Sean Kuraly
77,14,16,30,0.116,0.2,20212022,8476374,Sean Kuraly
47,4,5,9,0.045,0.41,20202021,8476374,Sean Kuraly
69,6,17,23,0.063,,20192020,8476374,Sean Kuraly
71,8,13,21,0.0597,,20182019,8476374,Sean Kuraly
75,6,8,14,0.0448,,20172018,8476374,Sean Kuraly
8,0,1,1,0.0,,20162017,8476374,Sean Kuraly
82,17,30,47,0.111842,5.73,20242025,8477496,Elias Lindholm
26,6,6,12,0.142857,5.79,20232024,8477496,Elias Lindholm
80,22,42,64,0.11828,7.4,20222023,8477496,Elias Lindholm
82,42,40,82,0.179,0.2,20212022,8477496,Elias Lindholm
56,19,28,47,0.146,0.41,20202021,8477496,Elias Lindholm
70,29,25,54,0.172,,20192020,8477496,Elias Lindholm
81,27,51,78,0.1484,,20182019,8477496,Elias Lindholm
81,16,28,44,0.1046,,20172018,8477496,Elias Lindholm
72,11,34,45,0.0728,,20162017,8477496,Elias Lindholm
82,11,28,39,0.0625,,20152016,8477496,Elias Lindholm
81,17,22,39,0.1,,20142015,8477496,Elias Lindholm
58,9,12,21,0.1286,,20132014,8477496,Elias Lindholm
18,4,2,6,0.173913,5.73,20242025,8479999,Casey Mittelstadt
18,4,6,10,0.16,5.79,20232024,8479999,Casey Mittelstadt
82,15,44,59,0.111111,7.4,20222023,8479999,Casey Mittelstadt
40,6,13,19,0.076,0.2,20212022,8479999,Casey Mittelstadt
41,10,12,22,0.164,0.41,20202021,8479999,Casey Mittelstadt
31,4,5,9,0.118,,20192020,8479999,Casey Mittelstadt
77,12,13,25,0.1017,,20182019,8479999,Casey Mittelstadt
6,1,4,5,0.1111,,20172018,8479999,Casey Mittelstadt
82,43,63,106,0.134796,5.73,20242025,8477956,David Pastrnak
82,47,63,110,0.123037,5.79,20232024,8477956,David Pastrnak
82,61,52,113,0.149877,7.4,20222023,8477956,David Pastrnak
72,40,37,77,0.128,0.2,20212022,8477956,David Pastrnak
48,20,28,48,0.114,0.41,20202021,8477956,David Pastrnak
70,48,47,95,0.172,,20192020,8477956,David Pastrnak
66,38,43,81,0.1617,,20182019,8477956,David Pastrnak
82,35,45,80,0.1423,,20172018,8477956,David Pastrnak
75,34,36,70,0.1298,,20162017,8477956,David Pastrnak
51,15,11,26,0.1389,,20152016,8477956,David Pastrnak
46,10,17,27,0.1075,,20142015,8477956,David Pastrnak
82,14,33,47,0.106061,5.73,20242025,8478401,Pavel Zacha
78,21,38,59,0.141892,5.79,20232024,8478401,Pavel Zacha
82,21,36,57,0.160305,7.4,20222023,8478401,Pavel Zacha
70,15,21,36,0.101,0.2,20212022,8478401,Pavel Zacha
50,17,18,35,0.165,0.41,20202021,8478401,Pavel Zacha
65,8,24,32,0.082,,20192020,8478401,Pavel Zacha
61,13,12,25,0.1313,,20182019,8478401,Pavel Zacha
69,8,17,25,0.0714,,20172018,8478401,Pavel Zacha
70,8,16,24,0.0964,,20162017,8478401,Pavel Zacha
1,0,2,2,0.0,,20152016,8478401,Pavel Zacha
18,0,4,4,0.0,5.73,20242025,8480035,Henri Jokiharju
74,3,17,20,0.035714,5.79,20232024,8480035,Henri Jokiharju
60,3,10,13,0.037975,7.4,20222023,8480035,Henri Jokiharju
60,3,16,19,0.036,0.2,20212022,8480035,Henri Jokiharju
46,3,5,8,0.06,0.41,20202021,8480035,Henri Jokiharju
69,4,11,15,0.051,,20192020,8480035,Henri Jokiharju
38,0,12,12,0.0,,20182019,8480035,Henri Jokiharju
17,3,4,7,0.085714,5.73,20242025,8476854,Hampus Lindholm
73,3,23,26,0.030303,5.79,20232024,8476854,Hampus Lindholm
80,10,43,53,0.063291,7.4,20222023,8476854,Hampus Lindholm
10,0,5,5,0.0,0.2,20212022,8476854,Hampus Lindholm
18,2,4,6,0.069,0.41,20202021,8476854,Hampus Lindholm
56,2,21,23,0.018,,20192020,8476854,Hampus Lindholm
76,6,22,28,0.048,,20182019,8476854,Hampus Lindholm
69,13,18,31,0.0992,,20172018,8476854,Hampus Lindholm
66,6,14,20,0.0638,,20162017,8476854,Hampus Lindholm
80,10,18,28,0.0671,,20152016,8476854,Hampus Lindholm
78,7,27,34,0.0654,,20142015,8476854,Hampus Lindholm
78,6,24,30,0.0517,,20132014,8476854,Hampus Lindholm
50,7,16,23,0.071429,5.73,20242025,8479325,Charlie McAvoy
74,12,35,47,0.090226,5.79,20232024,8479325,Charlie McAvoy
67,7,45,52,0.066667,7.4,20222023,8479325,Charlie McAvoy
78,10,46,56,0.06,0.2,20212022,8479325,Charlie McAvoy
51,5,25,30,0.054,0.41,20202021,8479325,Charlie McAvoy
67,5,27,32,0.05,,20192020,8479325,Charlie McAvoy
54,7,21,28,0.0886,,20182019,8479325,Charlie McAvoy
63,7,25,32,0.0909,,20172018,8479325,Charlie McAvoy
76,1,16,17,0.0125,5.73,20242025,8479369,Andrew Peeke
15,0,2,2,0.0,5.79,20232024,8479369,Andrew Peeke
80,6,7,13,0.066667,7.4,20222023,8479369,Andrew Peeke
82,2,13,15,0.028,0.2,20212022,8479369,Andrew Peeke
11,0,3,3,0.0,0.41,20202021,8479369,Andrew Peeke
22,1,2,3,0.043,,20192020,8479369,Andrew Peeke
81,4,18,22,0.038095,5.73,20242025,8477507,Nikita Zadorov
54,5,9,14,0.081967,5.79,20232024,8477507,Nikita Zadorov
82,14,7,21,0.107692,7.4,20222023,8477507,Nikita Zadorov
74,4,18,22,0.038,0.2,20212022,8477507,Nikita Zadorov
55,1,7,8,0.019,0.41,20202021,8477507,Nikita Zadorov
64,4,9,13,0.062,,20192020,8477507,Nikita Zadorov
70,7,7,14,0.07,,20182019,8477507,Nikita Zadorov
77,7,13,20,0.0745,,20172018,8477507,Nikita Zadorov
56,0,10,10,0.0,,20162017,8477507,Nikita Zadorov
22,0,2,2,0.0,,20152016,8477507,Nikita Zadorov
60,3,12,15,0.0577,,20142015,8477507,Nikita Zadorov
7,1,0,1,0.25,,20132014,8477507,Nikita Zadorov
34,3,5,8,0.083333,5.73,20242025,8478413,Jordan Greenway
67,10,18,28,0.093458,5.79,20232024,8478413,Jordan Greenway
17,4,0,4,0.129032,7.4,20222023,8478413,Jordan Greenway
62,10,17,27,0.091,0.2,20212022,8478413,Jordan Greenway
56,6,26,32,0.075,0.41,20202021,8478413,Jordan Greenway
67,8,20,28,0.086,,20192020,8478413,Jordan Greenway
81,12,12,24,0.1101,,20182019,8478413,Jordan Greenway
6,0,1,1,0.0,,20172018,8478413,Jordan Greenway
81,10,18,28,0.125,5.73,20242025,8481522,Peyton Krebs
80,4,13,17,0.054054,5.79,20232024,8481522,Peyton Krebs
74,9,17,26,0.115385,7.4,20222023,8481522,Peyton Krebs
48,7,15,22,0.152,0.2,20212022,8481522,Peyton Krebs
4,0,1,1,0.0,0.41,20202021,8481522,Peyton Krebs
76,4,6,10,0.059701,5.73,20242025,8479359,Beck Malenstyn
81,6,15,21,0.061224,5.79,20232024,8479359,Beck Malenstyn
9,1,1,2,0.142857,7.4,20222023,8479359,Beck Malenstyn
12,1,0,1,0.1,0.2,20212022,8479359,Beck Malenstyn
79,20,33,53,0.206186,5.73,20242025,8480802,Ryan McLeod
81,12,18,30,0.113208,5.79,20232024,8480802,Ryan McLeod
57,11,12,23,0.141026,7.4,20222023,8480802,Ryan McLeod
71,9,12,21,0.11,0.2,20212022,8480802,Ryan McLeod
10,0,1,1,0.0,0.41,20202021,8480802,Ryan McLeod
3,1,1,2,0.5,5.73,20242025,8480064,Josh Norris
50,16,14,30,0.13913,5.79,20232024,8480064,Josh Norris
8,2,1,3,0.133333,7.4,20222023,8480064,Josh Norris
66,35,20,55,0.203,0.2,20212022,8480064,Josh Norris
56,17,18,35,0.177,0.41,20202021,8480064,Josh Norris
3,0,0,0,0.0,,20192020,8480064,Josh Norris
76,44,28,72,0.181818,5.73,20242025,8479420,Tage Thompson
71,29,27,56,0.117886,5.79,20232024,8479420,Tage Thompson
78,47,47,94,0.159322,7.4,20222023,8479420,Tage Thompson
78,38,30,68,0.15,0.2,20212022,8479420,Tage Thompson
38,8,6,14,0.083,0.41,20202021,8479420,Tage Thompson
1,0,0,0,0.0,,20192020,8479420,Tage Thompson
65,7,5,12,0.0648,,20182019,8479420,Tage Thompson
41,3,6,9,0.0545,,20172018,8479420,Tage Thompson
82,36,31,67,0.183673,5.73,20242025,8477949,Alex Tuch
75,22,37,59,0.114583,5.79,20232024,8477949,Alex Tuch
74,36,43,79,0.165138,7.4,20222023,8477949,Alex Tuch
50,12,26,38,0.086,0.2,20212022,8477949,Alex Tuch
55,18,15,33,0.127,0.41,20202021,8477949,Alex Tuch
42,8,9,17,0.082,,20192020,8477949,Alex Tuch
74,20,32,52,0.1111,,20182019,8477949,Alex Tuch
78,15,22,37,0.0877,,20172018,8477949,Alex Tuch
6,0,0,0,0.0,,20162017,8477949,Alex Tuch
73,21,32,53,0.146853,5.73,20242025,8475722,Jason Zucker
18,5,2,7,0.108696,5.79,20232024,8475722,Jason Zucker
78,27,21,48,0.137056,7.4,20222023,8475722,Jason Zucker
41,8,9,17,0.078,0.2,20212022,8475722,Jason Zucker
38,9,9,18,0.134,0.41,20202021,8475722,Jason Zucker
15,6,6,12,0.167,,20192020,8475722,Jason Zucker
81,21,21,42,0.0981,,20182019,8475722,Jason Zucker
82,33,31,64,0.1486,,20172018,8475722,Jason Zucker
79,22,25,47,0.1279,,20162017,8475722,Jason Zucker
71,13,10,23,0.0823,,20152016,8475722,Jason Zucker
51,21,5,26,0.1694,,20142015,8475722,Jason Zucker
21,4,1,5,0.1,,20132014,8475722,Jason Zucker
20,4,1,5,0.1176,,20122013,8475722,Jason Zucker
6,0,2,2,0.0,,20112012,8475722,Jason Zucker
48,0,7,7,0.0,5.73,20242025,8480196,Jacob Bryson
36,1,7,8,0.066667,5.79,20232024,8480196,Jacob Bryson
59,1,8,9,0.037037,7.4,20222023,8480196,Jacob Bryson
73,1,9,10,0.023,0.2,20212022,8480196,Jacob Bryson
38,1,8,9,0.042,0.41,20202021,8480196,Jacob Bryson
82,7,31,38,0.074468,5.73,20242025,8481524,Bowen Byram
18,3,6,9,0.142857,5.79,20232024,8481524,Bowen Byram
42,10,14,24,0.153846,7.4,20222023,8481524,Bowen Byram
30,5,12,17,0.102,0.2,20212022,8481524,Bowen Byram
19,0,2,2,0.0,0.41,20202021,8481524,Bowen Byram
73,17,51,68,0.085,5.73,20242025,8480839,Rasmus Dahlin
81,20,39,59,0.085106,5.79,20232024,8480839,Rasmus Dahlin
78,15,58,73,0.073529,7.4,20222023,8480839,Rasmus Dahlin
80,13,40,53,0.076,0.2,20212022,8480839,Rasmus Dahlin
56,5,18,23,0.043,0.41,20202021,8480839,Rasmus Dahlin
59,4,36,40,0.044,,20192020,8480839,Rasmus Dahlin
82,9,35,44,0.0508,,20182019,8480839,Rasmus Dahlin
46,1,10,11,0.019608,5.73,20242025,8481708,Zac Jones
31,2,7,9,0.047619,5.79,20232024,8481708,Zac Jones
16,1,1,2,0.066667,7.4,20222023,8481708,Zac Jones
12,0,2,2,0.0,0.2,20212022,8481708,Zac Jones
10,0,4,4,0.0,0.41,20202021,8481708,Zac Jones
62,4,10,14,0.076923,5.73,20242025,8480807,Mattias Samuelsson
41,1,6,7,0.022727,5.79,20232024,8480807,Mattias Samuelsson
55,2,8,10,0.026316,7.4,20222023,8480807,Mattias Samuelsson
42,0,10,10,0.0,0.2,20212022,8480807,Mattias Samuelsson
12,0,2,2,0.0,0.41,20202021,8480807,Mattias Samuelsson
17,1,6,7,0.055556,5.73,20242025,8479982,Conor Timmins
25,1,9,10,0.04,5.79,20232024,8479982,Conor Timmins
25,2,12,14,0.125,7.4,20222023,8479982,Conor Timmins
6,0,0,0,0.0,0.2,20212022,8479982,Conor Timmins
31,0,7,7,0.0,0.41,20202021,8479982,Conor Timmins
2,0,0,0,0.0,,20192020,8479982,Conor Timmins
79,29,45,74,0.140097,5.73,20242025,8478427,Sebastian Aho
78,36,53,89,0.166667,5.79,20232024,8478427,Sebastian Aho
75,36,31,67,0.165138,7.4,20222023,8478427,Sebastian Aho
79,37,44,81,0.167,0.2,20212022,8478427,Sebastian Aho
56,24,33,57,0.162,0.41,20202021,8478427,Sebastian Aho
68,38,28,66,0.184,,20192020,8478427,Sebastian Aho
82,30,53,83,0.1235,,20182019,8478427,Sebastian Aho
78,29,36,65,0.145,,20172018,8478427,Sebastian Aho
82,24,25,49,0.1121,,20162017,8478427,Sebastian Aho
43,4,7,11,0.083333,5.73,20242025,8477478,William Carrier
39,6,2,8,0.092308,5.79,20232024,8477478,William Carrier
56,16,9,25,0.135593,7.4,20222023,8477478,William Carrier
63,9,11,20,0.075,0.2,20212022,8477478,William Carrier
52,6,9,15,0.092,0.41,20202021,8477478,William Carrier
71,7,12,19,0.071,,20192020,8477478,William Carrier
54,8,1,9,0.0941,,20182019,8477478,William Carrier
37,1,2,3,0.0192,,20172018,8477478,William Carrier
41,5,3,8,0.1,,20162017,8477478,William Carrier
69,24,39,63,0.137931,5.73,20242025,8477940,Nikolaj Ehlers
82,25,36,61,0.107296,5.79,20232024,8477940,Nikolaj Ehlers
45,12,26,38,0.090909,7.4,20222023,8477940,Nikolaj Ehlers
62,28,27,55,0.114,0.2,20212022,8477940,Nikolaj Ehlers
47,21,25,46,0.142,0.41,20202021,8477940,Nikolaj Ehlers
71,25,33,58,0.123,,20192020,8477940,Nikolaj Ehlers
62,21,16,37,0.1329,,20182019,8477940,Nikolaj Ehlers
82,29,31,60,0.1255,,20172018,8477940,Nikolaj Ehlers
82,25,39,64,0.1225,,20162017,8477940,Nikolaj Ehlers
72,15,23,38,0.0898,,20152016,8477940,Nikolaj Ehlers
31,9,9,18,0.145161,5.73,20242025,8475791,Taylor Hall
10,2,2,4,0.1,5.79,20232024,8475791,Taylor Hall
61,16,20,36,0.106667,7.4,20222023,8475791,Taylor Hall
81,20,41,61,0.092,0.2,20212022,8475791,Taylor Hall
16,8,6,14,0.167,0.41,20202021,8475791,Taylor Hall
35,10,17,27,0.081,,20192020,8475791,Taylor Hall
33,11,26,37,0.0973,,20182019,8475791,Taylor Hall
76,39,54,93,0.1403,,20172018,8475791,Taylor Hall
72,20,33,53,0.084,,20162017,8475791,Taylor Hall
82,26,39,65,0.0909,,20152016,8475791,Taylor Hall
53,14,24,38,0.0886,,20142015,8475791,Taylor Hall
75,27,53,80,0.108,,20132014,8475791,Taylor Hall
45,16,34,50,0.1039,,20122013,8475791,Taylor Hall
61,27,26,53,0.1304,,20112012,8475791,Taylor Hall
65,22,20,42,0.1183,,20102011,8475791,Taylor Hall
19,8,0,8,0.380952,5.73,20242025,8476873,Mark Jankowski
32,7,8,15,0.145833,5.79,20232024,8476873,Mark Jankowski
50,7,5,12,0.122807,7.4,20222023,8476873,Mark Jankowski
19,2,3,5,0.143,0.2,20212022,8476873,Mark Jankowski
45,4,7,11,0.114,0.41,20202021,8476873,Mark Jankowski
56,5,2,7,0.132,,20192020,8476873,Mark Jankowski
79,14,18,32,0.1414,,20182019,8476873,Mark Jankowski
72,17,8,25,0.1441,,20172018,8476873,Mark Jankowski
1,0,0,0,0.0,,20162017,8476873,Mark Jankowski
39,4,5,9,0.090909,5.73,20242025,8479370,Tyson Jost
43,3,3,6,0.0625,5.79,20232024,8479370,Tyson Jost
59,7,15,22,0.079545,7.4,20222023,8479370,Tyson Jost
21,2,4,6,0.095,0.2,20212022,8479370,Tyson Jost
54,7,10,17,0.076,0.41,20202021,8479370,Tyson Jost
67,8,15,23,0.07,,20192020,8479370,Tyson Jost
70,11,15,26,0.0965,,20182019,8479370,Tyson Jost
65,12,10,22,0.1062,,20172018,8479370,Tyson Jost
6,1,0,1,0.1111,,20162017,8479370,Tyson Jost
78,12,21,33,0.104348,5.73,20242025,8480829,Jesperi Kotkaniemi
79,12,15,27,0.09375,5.79,20232024,8480829,Jesperi Kotkaniemi
82,18,25,43,0.139535,7.4,20222023,8480829,Jesperi Kotkaniemi
66,12,17,29,0.148,0.2,20212022,8480829,Jesperi Kotkaniemi
56,5,15,20,0.057,0.41,20202021,8480829,Jesperi Kotkaniemi
36,6,2,8,0.109,,20192020,8480829,Jesperi Kotkaniemi
79,11,23,34,0.0821,,20182019,8480829,Jesperi Kotkaniemi
79,15,21,36,0.133929,5.73,20242025,8476921,Jordan Martinook
82,14,18,32,0.094595,5.79,20232024,8476921,Jordan Martinook
82,13,21,34,0.080247,7.4,20222023,8476921,Jordan Martinook
59,6,9,15,0.078,0.2,20212022,8476921,Jordan Martinook
44,4,9,13,0.065,0.41,20202021,8476921,Jordan Martinook
45,2,11,13,0.045,,20192020,8476921,Jordan Martinook
82,15,10,25,0.1027,,20182019,8476921,Jordan Martinook
81,6,9,15,0.0536,,20172018,8476921,Jordan Martinook
77,11,14,25,0.1009,,20162017,8476921,Jordan Martinook
81,9,15,24,0.0826,,20152016,8476921,Jordan Martinook
8,0,1,1,0.0,,20142015,8476921,Jordan Martinook
82,14,18,32,0.127273,5.73,20242025,8480762,Eric Robinson
40,2,7,9,0.038462,5.79,20232024,8480762,Eric Robinson
72,12,12,24,0.122449,7.4,20222023,8480762,Eric Robinson
67,10,17,27,0.096,0.2,20212022,8480762,Eric Robinson
56,8,10,18,0.107,0.41,20202021,8480762,Eric Robinson
50,7,5,12,0.101,,20192020,8480762,Eric Robinson
13,0,0,0,0.0,,20182019,8480762,Eric Robinson
1,0,0,0,0.0,,20172018,8480762,Eric Robinson
75,13,23,36,0.121495,5.73,20242025,8473533,Jordan Staal
80,10,20,30,0.081301,5.79,20232024,8473533,Jordan Staal
81,17,17,34,0.137097,7.4,20222023,8473533,Jordan Staal
78,17,19,36,0.116,0.2,20212022,8473533,Jordan Staal
53,16,22,38,0.155,0.41,20202021,8473533,Jordan Staal
68,8,19,27,0.064,,20192020,8473533,Jordan Staal
50,11,17,28,0.0909,,20182019,8473533,Jordan Staal
79,19,27,46,0.1188,,20172018,8473533,Jordan Staal
75,16,29,45,0.0976,,20162017,8473533,Jordan Staal
82,20,28,48,0.1325,,20152016,8473533,Jordan Staal
46,6,18,24,0.0652,,20142015,8473533,Jordan Staal
82,15,25,40,0.0909,,20132014,8473533,Jordan Staal
48,10,21,31,0.0877,,20122013,8473533,Jordan Staal
62,25,25,50,0.1678,,20112012,8473533,Jordan Staal
42,11,19,30,0.1209,,20102011,8473533,Jordan Staal
82,21,28,49,0.1077,,20092010,8473533,Jordan Staal
82,22,27,49,0.1325,,20082009,8473533,Jordan Staal
82,12,16,28,0.0656,,20072008,8473533,Jordan Staal
81,29,13,42,0.2214,,20062007,8473533,Jordan Staal
72,20,28,48,0.111111,5.73,20242025,8480830,Andrei Svechnikov
59,19,33,52,0.131944,5.79,20232024,8480830,Andrei Svechnikov
64,23,32,55,0.112195,7.4,20222023,8480830,Andrei Svechnikov
78,30,39,69,0.12,0.2,20212022,8480830,Andrei Svechnikov
55,15,27,42,0.102,0.41,20202021,8480830,Andrei Svechnikov
68,24,37,61,0.131,,20192020,8480830,Andrei Svechnikov
82,20,17,37,0.1058,,20182019,8480830,Andrei Svechnikov
79,7,11,18,0.061404,5.73,20242025,8478970,Jalen Chatfield
72,8,14,22,0.088889,5.79,20232024,8478970,Jalen Chatfield
78,6,8,14,0.064516,7.4,20222023,8478970,Jalen Chatfield
16,0,3,3,0.0,0.2,20212022,8478970,Jalen Chatfield
18,0,1,1,0.0,0.41,20202021,8478970,Jalen Chatfield
70,7,38,45,0.057377,5.73,20242025,8476906,Shayne Gostisbehere
81,10,46,56,0.071942,5.79,20232024,8476906,Shayne Gostisbehere
23,3,7,10,0.075,7.4,20222023,8476906,Shayne Gostisbehere
82,14,37,51,0.093,0.2,20212022,8476906,Shayne Gostisbehere
41,9,11,20,0.106,0.41,20202021,8476906,Shayne Gostisbehere
42,5,7,12,0.068,,20192020,8476906,Shayne Gostisbehere
78,9,28,37,0.05,,20182019,8476906,Shayne Gostisbehere
78,13,52,65,0.0588,,20172018,8476906,Shayne Gostisbehere
76,7,32,39,0.0354,,20162017,8476906,Shayne Gostisbehere
64,17,29,46,0.1118,,20152016,8476906,Shayne Gostisbehere
2,0,0,0,0.0,,20142015,8476906,Shayne Gostisbehere
74,7,20,27,0.063636,5.73,20242025,8480817,K'Andre Miller
80,8,22,30,0.083333,5.79,20232024,8480817,K'Andre Miller
79,9,34,43,0.079646,7.4,20222023,8480817,K'Andre Miller
82,7,13,20,0.069,0.2,20212022,8480817,K'Andre Miller
53,5,7,12,0.081,0.41,20202021,8480817,K'Andre Miller
18,0,2,2,0.0,5.73,20242025,8476422,Mike Reilly
59,6,18,24,0.05042,5.79,20232024,8476422,Mike Reilly
10,0,1,1,0.0,7.4,20222023,8476422,Mike Reilly
70,4,13,17,0.03,0.2,20212022,8476422,Mike Reilly
15,0,8,8,0.0,0.41,20202021,8476422,Mike Reilly
30,1,11,12,0.016,,20192020,8476422,Mike Reilly
57,3,8,11,0.0297,,20182019,8476422,Mike Reilly
19,0,8,8,0.0,,20172018,8476422,Mike Reilly
17,1,0,1,0.0526,,20162017,8476422,Mike Reilly
29,1,6,7,0.037,,20152016,8476422,Mike Reilly
80,6,21,27,0.054545,5.73,20242025,8476958,Jaccob Slavin
81,6,31,37,0.039735,5.79,20232024,8476958,Jaccob Slavin
76,7,20,27,0.053435,7.4,20222023,8476958,Jaccob Slavin
79,4,38,42,0.024,0.2,20212022,8476958,Jaccob Slavin
52,3,12,15,0.03,0.41,20202021,8476958,Jaccob Slavin
68,6,30,36,0.041,,20192020,8476958,Jaccob Slavin
82,8,23,31,0.0548,,20182019,8476958,Jaccob Slavin
82,8,22,30,0.0519,,20172018,8476958,Jaccob Slavin
82,5,29,34,0.0505,,20162017,8476958,Jaccob Slavin
63,2,18,20,0.0238,,20152016,8476958,Jaccob Slavin
82,5,11,16,0.034722,5.73,20242025,8480336,Sean Walker
18,4,3,7,0.097561,5.79,20232024,8480336,Sean Walker
70,3,10,13,0.031915,7.4,20222023,8480336,Sean Walker
6,0,2,2,0.0,0.2,20212022,8480336,Sean Walker
47,5,13,18,0.054,0.41,20202021,8480336,Sean Walker
70,5,19,24,0.039,,20192020,8480336,Sean Walker
39,3,7,10,0.0545,,20182019,8480336,Sean Walker
79,6,11,17,0.059406,5.73,20242025,8479944,Zachary Aston-Reese
3,0,0,0,0.0,5.79,20232024,8479944,Zachary Aston-Reese
77,10,4,14,0.11236,7.4,20222023,8479944,Zachary Aston-Reese
17,3,1,4,0.115,0.2,20212022,8479944,Zachary Aston-Reese
45,9,6,15,0.114,0.41,20202021,8479944,Zachary Aston-Reese
57,6,7,13,0.061,,20192020,8479944,Zachary Aston-Reese
43,8,9,17,0.1053,,20182019,8479944,Zachary Aston-Reese
16,4,2,6,0.2,,20172018,8479944,Zachary Aston-Reese
19,2,11,13,0.086957,5.73,20242025,8475745,Charlie Coyle
82,25,35,60,0.170068,5.79,20232024,8475745,Charlie Coyle
82,16,29,45,0.115108,7.4,20222023,8475745,Charlie Coyle
82,16,28,44,0.122,0.2,20212022,8475745,Charlie Coyle
51,6,10,16,0.076,0.41,20202021,8475745,Charlie Coyle
70,16,21,37,0.11,,20192020,8475745,Charlie Coyle
21,2,4,6,0.0476,,20182019,8475745,Charlie Coyle
66,11,26,37,0.094,,20172018,8475745,Charlie Coyle
82,18,38,56,0.1132,,20162017,8475745,Charlie Coyle
82,21,21,42,0.15,,20152016,8475745,Charlie Coyle
82,11,24,35,0.0917,,20142015,8475745,Charlie Coyle
70,12,18,30,0.0889,,20132014,8475745,Charlie Coyle
37,8,6,14,0.16,,20122013,8475745,Charlie Coyle
43,2,2,4,0.039216,5.73,20242025,8477392,Hudson Fasching
45,4,10,14,0.097561,5.79,20232024,8477392,Hudson Fasching
49,10,9,19,0.163934,7.4,20222023,8477392,Hudson Fasching
11,0,0,0,0.0,0.2,20212022,8477392,Hudson Fasching
5,0,0,0,0.0,0.41,20202021,8477392,Hudson Fasching
12,0,1,1,0.0,5.73,20242025,8476867,Brendan Gaunce
24,2,2,4,0.083333,5.79,20232024,8476867,Brendan Gaunce
5,0,1,1,0.0,7.4,20222023,8476867,Brendan Gaunce
30,5,2,7,0.114,0.2,20212022,8476867,Brendan Gaunce
26,7,12,19,0.1,5.73,20242025,8476432,Boone Jenner
58,22,13,35,0.141935,5.79,20232024,8476432,Boone Jenner
68,26,19,45,0.121495,7.4,20222023,8476432,Boone Jenner
59,23,21,44,0.144,0.2,20212022,8476432,Boone Jenner
41,8,9,17,0.101,0.41,20202021,8476432,Boone Jenner
70,11,13,24,0.061,,20192020,8476432,Boone Jenner
77,16,22,38,0.0941,,20182019,8476432,Boone Jenner
75,13,19,32,0.0695,,20172018,8476432,Boone Jenner
82,18,16,34,0.0853,,20162017,8476432,Boone Jenner
82,30,19,49,0.1333,,20152016,8476432,Boone Jenner
31,9,8,17,0.1084,,20142015,8476432,Boone Jenner
72,16,13,29,0.126,,20132014,8476432,Boone Jenner
79,4,11,15,0.066667,5.73,20242025,8480806,Isac Lundestrom
46,5,6,11,0.131579,5.79,20232024,8480806,Isac Lundestrom
61,4,10,14,0.066667,7.4,20222023,8480806,Isac Lundestrom
80,16,13,29,0.193,0.2,20212022,8480806,Isac Lundestrom
41,6,3,9,0.115,0.41,20202021,8480806,Isac Lundestrom
15,0,4,4,0.0,,20192020,8480806,Isac Lundestrom
15,0,2,2,0.0,,20182019,8480806,Isac Lundestrom
54,19,38,57,0.148438,5.73,20242025,8477497,Sean Monahan
34,13,11,24,0.19403,5.79,20232024,8477497,Sean Monahan
25,6,11,17,0.109091,7.4,20222023,8477497,Sean Monahan
65,8,15,23,0.072,0.2,20212022,8477497,Sean Monahan
50,10,18,28,0.102,0.41,20202021,8477497,Sean Monahan
70,22,26,48,0.133,,20192020,8477497,Sean Monahan
78,34,48,82,0.1611,,20182019,8477497,Sean Monahan
74,31,33,64,0.1535,,20172018,8477497,Sean Monahan
82,27,31,58,0.1357,,20162017,8477497,Sean Monahan
81,27,36,63,0.1371,,20152016,8477497,Sean Monahan
81,31,31,62,0.1623,,20142015,8477497,Sean Monahan
75,22,12,34,0.1571,,20132014,8477497,Sean Monahan
82,18,14,32,0.162162,5.73,20242025,8479671,Mathieu Olivier
54,5,7,12,0.090909,5.79,20232024,8479671,Mathieu Olivier
66,5,10,15,0.066667,7.4,20222023,8479671,Mathieu Olivier
10,0,1,1,0.0,0.2,20212022,8479671,Mathieu Olivier
30,3,2,5,0.12,0.41,20202021,8479671,Mathieu Olivier
8,0,1,1,0.0,,20192020,8479671,Mathieu Olivier
37,4,4,8,0.066667,5.73,20242025,8477425,Miles Wood
74,9,17,26,0.053892,5.79,20232024,8477425,Miles Wood
76,13,14,27,0.077844,7.4,20222023,8477425,Miles Wood
3,0,0,0,0.0,0.2,20212022,8477425,Miles Wood
55,17,8,25,0.134,0.41,20202021,8477425,Miles Wood
68,11,12,23,0.078,,20192020,8477425,Miles Wood
63,10,14,24,0.0629,,20182019,8477425,Miles Wood
76,19,13,32,0.1118,,20172018,8477425,Miles Wood
60,8,9,17,0.0762,,20162017,8477425,Miles Wood
1,0,0,0,0.0,,20152016,8477425,Miles Wood
62,9,17,26,0.109756,5.73,20242025,8479371,Dante Fabbro
56,3,10,13,0.046154,5.79,20232024,8479371,Dante Fabbro
79,2,9,11,0.019802,7.4,20222023,8479371,Dante Fabbro
66,3,21,24,0.034,0.2,20212022,8479371,Dante Fabbro
40,2,10,12,0.034,0.41,20202021,8479371,Dante Fabbro
64,5,6,11,0.054,,20192020,8479371,Dante Fabbro
4,1,0,1,0.2,,20182019,8479371,Dante Fabbro
16,0,4,4,0.0,5.73,20242025,8475790,Erik Gudbranson
78,6,20,26,0.065934,5.79,20232024,8475790,Erik Gudbranson
70,1,12,13,0.009804,7.4,20222023,8475790,Erik Gudbranson
78,6,11,17,0.047,0.2,20212022,8475790,Erik Gudbranson
9,0,1,1,0.0,0.41,20202021,8475790,Erik Gudbranson
44,4,5,9,0.053,,20192020,8475790,Erik Gudbranson
19,0,2,2,0.0,,20182019,8475790,Erik Gudbranson
52,2,3,5,0.0377,,20172018,8475790,Erik Gudbranson
30,1,5,6,0.025,,20162017,8475790,Erik Gudbranson
64,2,7,9,0.0274,,20152016,8475790,Erik Gudbranson
76,4,9,13,0.0364,,20142015,8475790,Erik Gudbranson
65,3,6,9,0.0326,,20132014,8475790,Erik Gudbranson
32,0,4,4,0.0,,20122013,8475790,Erik Gudbranson
72,2,6,8,0.0263,,20112012,8475790,Erik Gudbranson
82,7,26,33,0.07,5.73,20242025,8478500,Ivan Provorov
82,5,27,32,0.046729,5.79,20232024,8478500,Ivan Provorov
82,6,21,27,0.052174,7.4,20222023,8478500,Ivan Provorov
79,9,22,31,0.053,0.2,20212022,8478500,Ivan Provorov
56,7,19,26,0.056,0.41,20202021,8478500,Ivan Provorov
69,13,23,36,0.087,,20192020,8478500,Ivan Provorov
82,7,19,26,0.0483,,20182019,8478500,Ivan Provorov
82,17,24,41,0.0837,,20172018,8478500,Ivan Provorov
82,6,24,30,0.0373,,20162017,8478500,Ivan Provorov
70,6,19,25,0.065934,5.73,20242025,8476923,Damon Severson
67,9,19,28,0.102273,5.79,20232024,8476923,Damon Severson
81,7,26,33,0.068627,7.4,20222023,8476923,Damon Severson
80,11,35,46,0.07,0.2,20212022,8476923,Damon Severson
56,3,18,21,0.033,0.41,20202021,8476923,Damon Severson
69,8,23,31,0.07,,20192020,8476923,Damon Severson
82,11,28,39,0.0753,,20182019,8476923,Damon Severson
76,9,15,24,0.0744,,20172018,8476923,Damon Severson
80,3,28,31,0.024,,20162017,8476923,Damon Severson
72,1,20,21,0.0106,,20152016,8476923,Damon Severson
51,5,12,17,0.0538,,20142015,8476923,Damon Severson
81,23,59,82,0.077181,5.73,20242025,8478460,Zach Werenski
70,11,46,57,0.054455,5.79,20232024,8478460,Zach Werenski
13,3,5,8,0.073171,7.4,20222023,8478460,Zach Werenski
68,11,37,48,0.051,0.2,20212022,8478460,Zach Werenski
35,7,13,20,0.089,0.41,20202021,8478460,Zach Werenski
63,20,21,41,0.107,,20192020,8478460,Zach Werenski
82,11,33,44,0.0655,,20182019,8478460,Zach Werenski
77,16,21,37,0.0773,,20172018,8478460,Zach Werenski
78,11,36,47,0.0585,,20162017,8478460,Zach Werenski
76,15,17,32,0.085714,5.73,20242025,8474150,Mikael Backlund
82,15,24,39,0.07177,5.79,20232024,8474150,Mikael Backlund
82,19,37,56,0.073077,7.4,20222023,8474150,Mikael Backlund
82,12,27,39,0.056,0.2,20212022,8474150,Mikael Backlund
54,9,23,32,0.063,0.41,20202021,8474150,Mikael Backlund
70,16,29,45,0.102,,20192020,8474150,Mikael Backlund
77,21,26,47,0.1024,,20182019,8474150,Mikael Backlund
82,14,31,45,0.0654,,20172018,8474150,Mikael Backlund
81,22,31,53,0.1117,,20162017,8474150,Mikael Backlund
82,21,26,47,0.1355,,20152016,8474150,Mikael Backlund
52,10,17,27,0.0971,,20142015,8474150,Mikael Backlund
76,18,21,39,0.1011,,20132014,8474150,Mikael Backlund
32,8,8,16,0.0909,,20122013,8474150,Mikael Backlund
41,4,7,11,0.0471,,20112012,8474150,Mikael Backlund
73,10,15,25,0.0694,,20102011,8474150,Mikael Backlund
23,1,9,10,0.0213,,20092010,8474150,Mikael Backlund
1,0,0,0,0.0,,20082009,8474150,Mikael Backlund
6,1,0,1,0.25,5.73,20242025,8478056,Clark Bishop
82,15,24,39,0.07732,5.73,20242025,8476399,Blake Coleman
78,30,24,54,0.157068,5.79,20232024,8476399,Blake Coleman
82,18,20,38,0.095745,7.4,20222023,8476399,Blake Coleman
81,16,17,33,0.075,0.2,20212022,8476399,Blake Coleman
55,14,17,31,0.115,0.41,20202021,8476399,Blake Coleman
9,0,1,1,0.0,,20192020,8476399,Blake Coleman
78,22,14,36,0.1033,,20182019,8476399,Blake Coleman
79,13,12,25,0.089,,20172018,8476399,Blake Coleman
23,1,1,2,0.0345,,20162017,8476399,Blake Coleman
31,3,3,6,0.057692,5.73,20242025,8480797,Joel Farabee
82,22,28,50,0.120879,5.79,20232024,8480797,Joel Farabee
82,15,24,39,0.103448,7.4,20222023,8480797,Joel Farabee
63,17,17,34,0.143,0.2,20212022,8480797,Joel Farabee
55,20,18,38,0.164,0.41,20202021,8480797,Joel Farabee
52,8,13,21,0.099,,20192020,8480797,Joel Farabee
32,3,9,12,0.051724,5.73,20242025,8480028,Morgan Frost
71,13,28,41,0.096296,5.79,20232024,8480028,Morgan Frost
81,19,27,46,0.122581,7.4,20222023,8480028,Morgan Frost
55,5,11,16,0.059,0.2,20212022,8480028,Morgan Frost
2,0,0,0,0.0,0.41,20202021,8480028,Morgan Frost
20,2,5,7,0.065,,20192020,8480028,Morgan Frost
81,28,34,62,0.183007,5.73,20242025,8476456,Jonathan Huberdeau
81,12,40,52,0.083916,5.79,20232024,8476456,Jonathan Huberdeau
79,15,40,55,0.119048,7.4,20222023,8476456,Jonathan Huberdeau
80,30,85,115,0.135,0.2,20212022,8476456,Jonathan Huberdeau
55,20,41,61,0.164,0.41,20202021,8476456,Jonathan Huberdeau
69,23,55,78,0.151,,20192020,8476456,Jonathan Huberdeau
82,30,62,92,0.1327,,20182019,8476456,Jonathan Huberdeau
82,27,42,69,0.1324,,20172018,8476456,Jonathan Huberdeau
31,10,16,26,0.1163,,20162017,8476456,Jonathan Huberdeau
76,20,39,59,0.1149,,20152016,8476456,Jonathan Huberdeau
79,15,39,54,0.0888,,20142015,8476456,Jonathan Huberdeau
69,9,19,28,0.0833,,20132014,8476456,Jonathan Huberdeau
48,14,17,31,0.125,,20122013,8476456,Jonathan Huberdeau
5,0,3,3,0.0,5.73,20242025,8478211,Dryden Hunt
28,3,5,8,0.090909,5.79,20232024,8478211,Dryden Hunt
9,1,0,1,0.166667,7.4,20222023,8478211,Dryden Hunt
76,6,11,17,0.064,0.2,20212022,8478211,Dryden Hunt
26,3,5,8,0.077,0.41,20202021,8478211,Dryden Hunt
21,0,4,4,0.0,,20192020,8478211,Dryden Hunt
31,3,7,10,0.0566,,20182019,8478211,Dryden Hunt
11,0,1,1,0.0,,20172018,8478211,Dryden Hunt
82,35,32,67,0.125448,5.73,20242025,8475172,Nazem Kadri
82,29,46,75,0.104693,5.79,20232024,8475172,Nazem Kadri
82,24,32,56,0.089888,7.4,20222023,8475172,Nazem Kadri
71,28,59,87,0.113,0.2,20212022,8475172,Nazem Kadri
56,11,21,32,0.065,0.41,20202021,8475172,Nazem Kadri
51,19,17,36,0.143,,20192020,8475172,Nazem Kadri
73,16,28,44,0.087,,20182019,8475172,Nazem Kadri
80,32,23,55,0.1517,,20172018,8475172,Nazem Kadri
82,32,29,61,0.1356,,20162017,8475172,Nazem Kadri
76,17,28,45,0.0654,,20152016,8475172,Nazem Kadri
73,18,21,39,0.1023,,20142015,8475172,Nazem Kadri
78,20,30,50,0.1351,,20132014,8475172,Nazem Kadri
48,18,26,44,0.1682,,20122013,8475172,Nazem Kadri
21,5,2,7,0.1786,,20112012,8475172,Nazem Kadri
29,3,9,12,0.0588,,20102011,8475172,Nazem Kadri
1,0,0,0,0.0,,20092010,8475172,Nazem Kadri
80,3,10,13,0.045455,5.73,20242025,8479066,Ryan Lomberg
75,5,2,7,0.073529,5.79,20232024,8479066,Ryan Lomberg
82,12,8,20,0.089552,7.4,20222023,8479066,Ryan Lomberg
55,9,9,18,0.099,0.2,20212022,8479066,Ryan Lomberg
34,2,2,4,0.043,0.41,20202021,8479066,Ryan Lomberg
73,17,15,32,0.132813,5.73,20242025,8481068,Yegor Sharangovich
82,31,28,59,0.173184,5.79,20232024,8481068,Yegor Sharangovich
75,13,17,30,0.099237,7.4,20222023,8481068,Yegor Sharangovich
76,24,22,46,0.143,0.2,20212022,8481068,Yegor Sharangovich
54,16,14,30,0.14,0.41,20202021,8481068,Yegor Sharangovich
81,11,20,31,0.067485,5.73,20242025,8478397,Rasmus Andersson
78,9,30,39,0.056604,5.79,20232024,8478397,Rasmus Andersson
79,11,38,49,0.069182,7.4,20222023,8478397,Rasmus Andersson
82,4,46,50,0.026,0.2,20212022,8478397,Rasmus Andersson
56,5,16,21,0.052,0.41,20202021,8478397,Rasmus Andersson
70,5,17,22,0.04,,20192020,8478397,Rasmus Andersson
79,2,17,19,0.0174,,20182019,8478397,Rasmus Andersson
10,0,0,0,0.0,,20172018,8478397,Rasmus Andersson
1,0,0,0,0.0,,20162017,8478397,Rasmus Andersson
73,3,17,20,0.036585,5.73,20242025,8480860,Kevin Bahl
82,1,10,11,0.015873,5.79,20232024,8480860,Kevin Bahl
42,2,6,8,0.074074,7.4,20222023,8480860,Kevin Bahl
17,1,3,4,0.063,0.2,20212022,8480860,Kevin Bahl
7,0,2,2,0.0,0.41,20202021,8480860,Kevin Bahl
64,2,5,7,0.028169,5.73,20242025,8479402,Jake Bean
72,4,9,13,0.052632,5.79,20232024,8479402,Jake Bean
14,1,5,6,0.0625,7.4,20222023,8479402,Jake Bean
67,7,18,25,0.078,0.2,20212022,8479402,Jake Bean
42,1,11,12,0.018,0.41,20202021,8479402,Jake Bean
53,2,7,9,0.047619,5.73,20242025,8477810,Joel Hanley
10,1,1,2,0.142857,5.79,20232024,8477810,Joel Hanley
26,0,2,2,0.0,7.4,20222023,8477810,Joel Hanley
44,2,4,6,0.111,0.2,20212022,8477810,Joel Hanley
35,0,8,8,0.0,0.41,20202021,8477810,Joel Hanley
8,0,2,2,0.0,,20192020,8477810,Joel Hanley
16,0,0,0,0.0,,20182019,8477810,Joel Hanley
5,0,0,0,0.0,,20172018,8477810,Joel Hanley
7,0,0,0,0.0,,20162017,8477810,Joel Hanley
10,0,6,6,0.0,,20152016,8477810,Joel Hanley
81,8,39,47,0.043478,5.73,20242025,8477346,MacKenzie Weegar
82,20,32,52,0.096154,5.79,20232024,8477346,MacKenzie Weegar
81,4,27,31,0.025,7.4,20222023,8477346,MacKenzie Weegar
80,8,36,44,0.039,0.2,20212022,8477346,MacKenzie Weegar
54,6,30,36,0.059,0.41,20202021,8477346,MacKenzie Weegar
45,7,11,18,0.091,,20192020,8477346,MacKenzie Weegar
64,4,11,15,0.0506,,20182019,8477346,MacKenzie Weegar
60,2,6,8,0.0345,,20172018,8477346,MacKenzie Weegar
3,0,0,0,0.0,,20162017,8477346,MacKenzie Weegar
18,0,1,1,0.0,5.73,20242025,8479315,Joey Anderson
55,5,12,17,0.087719,5.79,20232024,8479315,Joey Anderson
24,4,2,6,0.142857,7.4,20222023,8479315,Joey Anderson
5,0,0,0,0.0,0.2,20212022,8479315,Joey Anderson
1,0,0,0,0.0,0.41,20202021,8479315,Joey Anderson
18,4,2,6,0.19,,20192020,8479315,Joey Anderson
34,4,3,7,0.0816,,20182019,8479315,Joey Anderson
82,23,23,46,0.175573,5.73,20242025,8477479,Tyler Bertuzzi
80,21,22,43,0.13125,5.79,20232024,8477479,Tyler Bertuzzi
21,4,12,16,0.088889,7.4,20222023,8477479,Tyler Bertuzzi
68,30,32,62,0.167,0.2,20212022,8477479,Tyler Bertuzzi
9,5,2,7,0.25,0.41,20202021,8477479,Tyler Bertuzzi
71,21,27,48,0.163,,20192020,8477479,Tyler Bertuzzi
73,21,26,47,0.1603,,20182019,8477479,Tyler Bertuzzi
48,7,17,24,0.0843,,20172018,8477479,Tyler Bertuzzi
7,0,0,0,0.0,,20162017,8477479,Tyler Bertuzzi
79,10,27,37,0.086957,5.73,20242025,8477444,Andre Burakovsky
49,7,9,16,0.076087,5.79,20232024,8477444,Andre Burakovsky
49,13,26,39,0.12381,7.4,20222023,8477444,Andre Burakovsky
80,22,39,61,0.148,0.2,20212022,8477444,Andre Burakovsky
53,19,25,44,0.186,0.41,20202021,8477444,Andre Burakovsky
58,20,25,45,0.194,,20192020,8477444,Andre Burakovsky
76,12,13,25,0.12,,20182019,8477444,Andre Burakovsky
56,12,13,25,0.1429,,20172018,8477444,Andre Burakovsky
64,12,23,35,0.1081,,20162017,8477444,Andre Burakovsky
79,17,21,38,0.1349,,20152016,8477444,Andre Burakovsky
53,9,13,22,0.1385,,20142015,8477444,Andre Burakovsky
59,7,9,16,0.125,5.73,20242025,8477450,Jason Dickinson
82,22,13,35,0.174603,5.79,20232024,8477450,Jason Dickinson
78,9,21,30,0.078947,7.4,20222023,8477450,Jason Dickinson
62,5,6,11,0.076,0.2,20212022,8477450,Jason Dickinson
51,7,8,15,0.106,0.41,20202021,8477450,Jason Dickinson
65,9,12,21,0.106,,20192020,8477450,Jason Dickinson
67,6,16,22,0.0638,,20182019,8477450,Jason Dickinson
27,0,2,2,0.0,,20172018,8477450,Jason Dickinson
10,2,0,2,0.2222,,20162017,8477450,Jason Dickinson
1,1,0,1,0.5,,20152016,8477450,Jason Dickinson
80,31,31,62,0.17033,5.73,20242025,8477987,Ryan Donato
78,12,18,30,0.080537,5.79,20232024,8477987,Ryan Donato
71,14,13,27,0.114754,7.4,20222023,8477987,Ryan Donato
74,16,15,31,0.101,0.2,20212022,8477987,Ryan Donato
50,6,14,20,0.058,0.41,20202021,8477987,Ryan Donato
62,14,9,23,0.147,,20192020,8477987,Ryan Donato
22,4,12,16,0.0625,,20182019,8477987,Ryan Donato
12,5,4,9,0.2083,,20172018,8477987,Ryan Donato
78,15,20,35,0.144231,5.73,20242025,8473422,Nick Foligno
74,17,20,37,0.116438,5.79,20232024,8473422,Nick Foligno
60,10,16,26,0.140845,7.4,20222023,8473422,Nick Foligno
64,2,11,13,0.02,0.2,20212022,8473422,Nick Foligno
7,0,4,4,0.0,0.41,20202021,8473422,Nick Foligno
67,10,21,31,0.076,,20192020,8473422,Nick Foligno
73,17,18,35,0.1206,,20182019,8473422,Nick Foligno
72,15,18,33,0.1095,,20172018,8473422,Nick Foligno
79,26,25,51,0.1405,,20162017,8473422,Nick Foligno
72,12,25,37,0.0805,,20152016,8473422,Nick Foligno
79,31,42,73,0.1703,,20142015,8473422,Nick Foligno
70,18,21,39,0.1622,,20132014,8473422,Nick Foligno
45,6,13,19,0.087,,20122013,8473422,Nick Foligno
82,15,32,47,0.098,,20112012,8473422,Nick Foligno
82,14,20,34,0.094,,20102011,8473422,Nick Foligno
61,9,17,26,0.1084,,20092010,8473422,Nick Foligno
81,17,15,32,0.1172,,20082009,8473422,Nick Foligno
45,6,3,9,0.1364,,20072008,8473422,Nick Foligno
60,4,3,7,0.08,5.73,20242025,8478043,Sam Lafferty
79,13,11,24,0.166667,5.79,20232024,8478043,Sam Lafferty
19,2,4,6,0.105263,7.4,20222023,8478043,Sam Lafferty
46,5,6,11,0.07,0.2,20212022,8478043,Sam Lafferty
34,0,6,6,0.0,0.41,20202021,8478043,Sam Lafferty
50,6,7,13,0.107,,20192020,8478043,Sam Lafferty
80,20,14,34,0.144928,5.73,20242025,8481624,Ilya Mikheyev
78,11,20,31,0.07483,5.79,20232024,8481624,Ilya Mikheyev
46,13,15,28,0.142857,7.4,20222023,8481624,Ilya Mikheyev
53,21,11,32,0.143,0.2,20212022,8481624,Ilya Mikheyev
54,7,10,17,0.065,0.41,20202021,8481624,Ilya Mikheyev
39,8,15,23,0.082,,20192020,8481624,Ilya Mikheyev
82,15,43,58,0.135135,5.73,20242025,8476882,Teuvo Teravainen
76,25,28,53,0.176056,5.79,20232024,8476882,Teuvo Teravainen
68,12,25,37,0.083333,7.4,20222023,8476882,Teuvo Teravainen
77,22,43,65,0.109,0.2,20212022,8476882,Teuvo Teravainen
21,5,10,15,0.102,0.41,20202021,8476882,Teuvo Teravainen
68,15,48,63,0.082,,20192020,8476882,Teuvo Teravainen
82,21,55,76,0.1257,,20182019,8476882,Teuvo Teravainen
82,23,41,64,0.1243,,20172018,8476882,Teuvo Teravainen
81,15,27,42,0.0888,,20162017,8476882,Teuvo Teravainen
78,13,22,35,0.0956,,20152016,8476882,Teuvo Teravainen
34,4,5,9,0.0606,,20142015,8476882,Teuvo Teravainen
3,0,0,0,0.0,,20132014,8476882,Teuvo Teravainen
5,0,0,0,0.0,5.73,20242025,8476952,Dominic Toninato
15,1,4,5,0.083333,5.79,20232024,8476952,Dominic Toninato
5,0,1,1,0.0,7.4,20222023,8476952,Dominic Toninato
77,7,7,14,0.159,0.2,20212022,8476952,Dominic Toninato
2,0,1,1,0.0,0.41,20202021,8476952,Dominic Toninato
46,4,7,11,0.105,,20192020,8476952,Dominic Toninato
2,1,0,1,1.0,,20182019,8476952,Dominic Toninato
37,0,2,2,0.0,,20172018,8476952,Dominic Toninato
68,2,17,19,0.02381,5.73,20242025,8476473,Connor Murphy
46,2,6,8,0.039216,5.79,20232024,8476473,Connor Murphy
80,7,6,13,0.082353,7.4,20222023,8476473,Connor Murphy
57,4,6,10,0.056,0.2,20212022,8476473,Connor Murphy
50,3,12,15,0.038,0.41,20202021,8476473,Connor Murphy
58,5,14,19,0.043,,20192020,8476473,Connor Murphy
52,5,8,13,0.0595,,20182019,8476473,Connor Murphy
76,2,12,14,0.0183,,20172018,8476473,Connor Murphy
77,2,15,17,0.0247,,20162017,8476473,Connor Murphy
78,6,11,17,0.0594,,20152016,8476473,Connor Murphy
73,4,3,7,0.0556,,20142015,8476473,Connor Murphy
30,1,7,8,0.0333,,20132014,8476473,Connor Murphy
2,0,0,0,0.0,5.73,20242025,8479718,Alex Barré-Boulet
36,6,3,9,0.130435,5.79,20232024,8479718,Alex Barré-Boulet
1,0,0,0,0.0,7.4,20222023,8479718,Alex Barré-Boulet
14,3,2,5,0.188,0.2,20212022,8479718,Alex Barré-Boulet
15,3,0,3,0.115,0.41,20202021,8479718,Alex Barré-Boulet
61,16,13,29,0.128,5.73,20242025,8479525,Ross Colton
80,17,23,40,0.116438,5.79,20232024,8479525,Ross Colton
81,16,16,32,0.104575,7.4,20222023,8479525,Ross Colton
79,22,17,39,0.138,0.2,20212022,8479525,Ross Colton
30,9,3,12,0.196,0.41,20202021,8479525,Ross Colton
80,8,11,19,0.080808,5.73,20242025,8480448,Parker Kelly
80,8,10,18,0.093023,5.79,20232024,8480448,Parker Kelly
55,1,3,4,0.016949,7.4,20222023,8480448,Parker Kelly
41,7,5,12,0.146,0.2,20212022,8480448,Parker Kelly
1,1,0,1,1.0,0.41,20202021,8480448,Parker Kelly
79,16,7,23,0.190476,5.73,20242025,8481641,Joel Kiviranta
56,3,6,9,0.0625,5.79,20232024,8481641,Joel Kiviranta
70,8,1,9,0.094118,7.4,20222023,8481641,Joel Kiviranta
56,1,6,7,0.017,0.2,20212022,8481641,Joel Kiviranta
26,6,5,11,0.194,0.41,20202021,8481641,Joel Kiviranta
11,1,0,1,0.077,,20192020,8481641,Joel Kiviranta
69,27,18,45,0.182432,5.73,20242025,8477476,Artturi Lehkonen
45,16,18,34,0.15534,5.79,20232024,8477476,Artturi Lehkonen
64,21,30,51,0.14,7.4,20222023,8477476,Artturi Lehkonen
16,6,3,9,0.133,0.2,20212022,8477476,Artturi Lehkonen
47,7,6,13,0.09,0.41,20202021,8477476,Artturi Lehkonen
70,13,14,27,0.093,,20192020,8477476,Artturi Lehkonen
82,11,20,31,0.0625,,20182019,8477476,Artturi Lehkonen
66,12,9,21,0.0732,,20172018,8477476,Artturi Lehkonen
73,18,10,28,0.1139,,20162017,8477476,Artturi Lehkonen
79,32,84,116,0.1,5.73,20242025,8477492,Nathan MacKinnon
82,51,89,140,0.125926,5.79,20232024,8477492,Nathan MacKinnon
71,42,69,111,0.114754,7.4,20222023,8477492,Nathan MacKinnon
65,32,56,88,0.107,0.2,20212022,8477492,Nathan MacKinnon
48,20,45,65,0.097,0.41,20202021,8477492,Nathan MacKinnon
69,35,58,93,0.11,,20192020,8477492,Nathan MacKinnon
82,41,58,99,0.1123,,20182019,8477492,Nathan MacKinnon
74,39,58,97,0.1373,,20172018,8477492,Nathan MacKinnon
82,16,37,53,0.0637,,20162017,8477492,Nathan MacKinnon
72,21,31,52,0.0857,,20152016,8477492,Nathan MacKinnon
64,14,24,38,0.0729,,20142015,8477492,Nathan MacKinnon
82,24,39,63,0.0996,,20132014,8477492,Nathan MacKinnon
30,11,17,28,0.135802,5.73,20242025,8480039,Martin Necas
77,24,29,53,0.103896,5.79,20232024,8480039,Martin Necas
82,28,43,71,0.116667,7.4,20222023,8480039,Martin Necas
78,14,26,40,0.088,0.2,20212022,8480039,Martin Necas
53,14,27,41,0.123,0.41,20202021,8480039,Martin Necas
64,16,20,36,0.182,,20192020,8480039,Martin Necas
7,1,1,2,0.1667,,20182019,8480039,Martin Necas
1,0,0,0,0.0,,20172018,8480039,Martin Necas
19,6,7,13,0.193548,5.73,20242025,8475754,Brock Nelson
82,34,35,69,0.136,5.79,20232024,8475754,Brock Nelson
82,36,39,75,0.162162,7.4,20222023,8475754,Brock Nelson
72,37,22,59,0.216,0.2,20212022,8475754,Brock Nelson
56,18,15,33,0.149,0.41,20202021,8475754,Brock Nelson
68,26,28,54,0.149,,20192020,8475754,Brock Nelson
82,25,28,53,0.1381,,20182019,8475754,Brock Nelson
82,19,16,35,0.1377,,20172018,8475754,Brock Nelson
81,20,25,45,0.1156,,20162017,8475754,Brock Nelson
81,26,14,40,0.1576,,20152016,8475754,Brock Nelson
82,20,22,42,0.1053,,20142015,8475754,Brock Nelson
72,14,12,26,0.1061,,20132014,8475754,Brock Nelson
43,21,13,34,0.177966,5.73,20242025,8477501,Valeri Nichushkin
54,28,25,53,0.177215,5.79,20232024,8477501,Valeri Nichushkin
53,17,30,47,0.107595,7.4,20222023,8477501,Valeri Nichushkin
62,25,27,52,0.139,0.2,20212022,8477501,Valeri Nichushkin
55,10,11,21,0.102,0.41,20202021,8477501,Valeri Nichushkin
65,13,14,27,0.115,,20192020,8477501,Valeri Nichushkin
57,0,10,10,0.0,,20182019,8477501,Valeri Nichushkin
80,10,11,21,0.11236,5.73,20242025,8481186,Logan O'Connor
57,13,12,25,0.152941,5.79,20232024,8481186,Logan O'Connor
82,9,17,26,0.086538,7.4,20222023,8481186,Logan O'Connor
81,8,16,24,0.063,0.2,20212022,8481186,Logan O'Connor
22,3,2,5,0.081,0.41,20202021,8481186,Logan O'Connor
16,2,0,2,0.133,,20192020,8481186,Logan O'Connor
5,0,0,0,0.0,,20182019,8481186,Logan O'Connor
56,15,14,29,0.137615,5.73,20242025,8478109,Victor Olofsson
51,7,8,15,0.106061,5.79,20232024,8478109,Victor Olofsson
75,28,12,40,0.173913,7.4,20222023,8478109,Victor Olofsson
72,20,29,49,0.122,0.2,20212022,8478109,Victor Olofsson
56,13,19,32,0.101,0.41,20202021,8478109,Victor Olofsson
54,20,22,42,0.157,,20192020,8478109,Victor Olofsson
6,2,2,4,0.0952,,20182019,8478109,Victor Olofsson
82,6,23,29,0.034483,5.73,20242025,8470613,Brent Burns
82,10,33,43,0.054054,5.79,20232024,8470613,Brent Burns
82,18,43,61,0.070588,7.4,20222023,8470613,Brent Burns
82,10,44,54,0.049,0.2,20212022,8470613,Brent Burns
56,7,22,29,0.051,0.41,20202021,8470613,Brent Burns
70,12,33,45,0.053,,20192020,8470613,Brent Burns
82,16,67,83,0.0533,,20182019,8470613,Brent Burns
82,12,55,67,0.0361,,20172018,8470613,Brent Burns
82,29,47,76,0.0906,,20162017,8470613,Brent Burns
82,27,48,75,0.0765,,20152016,8470613,Brent Burns
82,17,43,60,0.0694,,20142015,8470613,Brent Burns
69,22,26,48,0.0898,,20132014,8470613,Brent Burns
30,9,11,20,0.1111,,20122013,8470613,Brent Burns
81,11,26,37,0.0547,,20112012,8470613,Brent Burns
80,17,29,46,0.1,,20102011,8470613,Brent Burns
47,3,17,20,0.0288,,20092010,8470613,Brent Burns
59,8,19,27,0.0544,,20082009,8470613,Brent Burns
82,15,28,43,0.0949,,20072008,8470613,Brent Burns
77,7,18,25,0.0648,,20062007,8470613,Brent Burns
72,4,12,16,0.0548,,20052006,8470613,Brent Burns
73,3,21,24,0.031579,5.73,20242025,8479398,Samuel Girard
59,3,15,18,0.041096,5.79,20232024,8479398,Samuel Girard
76,6,31,37,0.05042,7.4,20222023,8479398,Samuel Girard
67,5,23,28,0.063,0.2,20212022,8479398,Samuel Girard
48,5,27,32,0.063,0.41,20202021,8479398,Samuel Girard
70,4,30,34,0.042,,20192020,8479398,Samuel Girard
82,4,23,27,0.0345,,20182019,8479398,Samuel Girard
68,3,17,20,0.0395,,20172018,8479398,Samuel Girard
80,30,62,92,0.121951,5.73,20242025,8480069,Cale Makar
77,21,69,90,0.090909,5.79,20232024,8480069,Cale Makar
60,17,49,66,0.096591,7.4,20222023,8480069,Cale Makar
77,28,58,86,0.117,0.2,20212022,8480069,Cale Makar
44,8,36,44,0.077,0.41,20202021,8480069,Cale Makar
57,12,38,50,0.099,,20192020,8480069,Cale Makar
48,1,14,15,0.015385,5.73,20242025,8476312,Josh Manson
76,8,17,25,0.065041,5.79,20232024,8476312,Josh Manson
27,2,8,10,0.04878,7.4,20222023,8476312,Josh Manson
22,2,5,7,0.065,0.2,20212022,8476312,Josh Manson
23,1,6,7,0.053,0.41,20202021,8476312,Josh Manson
50,1,8,9,0.016,,20192020,8476312,Josh Manson
74,3,13,16,0.0313,,20182019,8476312,Josh Manson
80,7,30,37,0.0598,,20172018,8476312,Josh Manson
82,5,12,17,0.0568,,20162017,8476312,Josh Manson
71,5,10,15,0.0568,,20152016,8476312,Josh Manson
28,0,3,3,0.0,,20142015,8476312,Josh Manson
76,10,34,44,0.072464,5.73,20242025,8478038,Devon Toews
82,12,38,50,0.075472,5.79,20232024,8478038,Devon Toews
80,7,43,50,0.042424,7.4,20222023,8478038,Devon Toews
66,13,44,57,0.082,0.2,20212022,8478038,Devon Toews
53,9,22,31,0.074,0.41,20202021,8478038,Devon Toews
68,6,22,28,0.049,,20192020,8478038,Devon Toews
48,5,13,18,0.0617,,20182019,8478038,Devon Toews
59,4,6,10,0.090909,5.73,20242025,8479414,Nathan Bastian
54,5,7,12,0.087719,5.79,20232024,8479414,Nathan Bastian
43,6,9,15,0.096774,7.4,20222023,8479414,Nathan Bastian
60,11,5,16,0.126,0.2,20212022,8479414,Nathan Bastian
41,3,7,10,0.065,0.41,20202021,8479414,Nathan Bastian
80,16,33,49,0.117647,5.73,20242025,8473994,Jamie Benn
82,21,39,60,0.128049,5.79,20232024,8473994,Jamie Benn
82,33,45,78,0.173684,7.4,20222023,8473994,Jamie Benn
82,18,28,46,0.099,0.2,20212022,8473994,Jamie Benn
52,11,24,35,0.089,0.41,20202021,8473994,Jamie Benn
69,19,20,39,0.117,,20192020,8473994,Jamie Benn
78,27,26,53,0.1429,,20182019,8473994,Jamie Benn
82,36,43,79,0.1494,,20172018,8473994,Jamie Benn
77,26,43,69,0.1294,,20162017,8473994,Jamie Benn
82,41,48,89,0.166,,20152016,8473994,Jamie Benn
82,35,52,87,0.1383,,20142015,8473994,Jamie Benn
81,34,45,79,0.1219,,20132014,8473994,Jamie Benn
41,12,21,33,0.1091,,20122013,8473994,Jamie Benn
71,26,37,63,0.1281,,20112012,8473994,Jamie Benn
69,22,34,56,0.1243,,20102011,8473994,Jamie Benn
82,22,19,41,0.1209,,20092010,8473994,Jamie Benn
63,6,11,17,0.095238,5.73,20242025,8476278,Colin Blackwell
44,8,4,12,0.090909,5.79,20232024,8476278,Colin Blackwell
53,2,8,10,0.037736,7.4,20222023,8476278,Colin Blackwell
19,2,1,3,0.125,0.2,20212022,8476278,Colin Blackwell
47,12,10,22,0.188,0.41,20202021,8476278,Colin Blackwell
27,3,7,10,0.097,,20192020,8476278,Colin Blackwell
6,0,0,0,0.0,,20182019,8476278,Colin Blackwell
82,30,52,82,0.197368,5.73,20242025,8475168,Matt Duchene
80,25,40,65,0.145349,5.79,20232024,8475168,Matt Duchene
71,22,34,56,0.130952,7.4,20222023,8475168,Matt Duchene
78,43,43,86,0.189,0.2,20212022,8475168,Matt Duchene
34,6,7,13,0.082,0.41,20202021,8475168,Matt Duchene
66,13,29,42,0.096,,20192020,8475168,Matt Duchene
23,4,8,12,0.087,,20182019,8475168,Matt Duchene
68,23,26,49,0.1377,,20172018,8475168,Matt Duchene
77,18,23,41,0.1125,,20162017,8475168,Matt Duchene
76,30,29,59,0.15,,20152016,8475168,Matt Duchene
82,21,34,55,0.1014,,20142015,8475168,Matt Duchene
71,23,47,70,0.106,,20132014,8475168,Matt Duchene
47,17,26,43,0.1288,,20122013,8475168,Matt Duchene
58,14,14,28,0.1061,,20112012,8475168,Matt Duchene
80,27,40,67,0.1337,,20102011,8475168,Matt Duchene
81,24,31,55,0.1333,,20092010,8475168,Matt Duchene
70,5,10,15,0.073529,5.73,20242025,8476889,Radek Faksa
74,7,12,19,0.098592,5.79,20232024,8476889,Radek Faksa
81,11,9,20,0.125,7.4,20222023,8476889,Radek Faksa
77,5,14,19,0.056,0.2,20212022,8476889,Radek Faksa
55,6,8,14,0.064,0.41,20202021,8476889,Radek Faksa
66,11,9,20,0.101,,20192020,8476889,Radek Faksa
81,15,15,30,0.1316,,20182019,8476889,Radek Faksa
79,17,16,33,0.1441,,20172018,8476889,Radek Faksa
80,12,21,33,0.0909,,20162017,8476889,Radek Faksa
45,5,7,12,0.0746,,20152016,8476889,Radek Faksa
76,28,39,67,0.175,5.73,20242025,8478449,Roope Hintz
80,30,35,65,0.164835,5.79,20232024,8478449,Roope Hintz
73,37,38,75,0.201087,7.4,20222023,8478449,Roope Hintz
80,37,35,72,0.174,0.2,20212022,8478449,Roope Hintz
41,15,28,43,0.163,0.41,20202021,8478449,Roope Hintz
60,19,14,33,0.158,,20192020,8478449,Roope Hintz
58,9,13,22,0.0909,,20182019,8478449,Roope Hintz
20,5,13,18,0.135135,5.73,20242025,8478420,Mikko Rantanen
80,42,62,104,0.154982,5.79,20232024,8478420,Mikko Rantanen
82,55,50,105,0.179739,7.4,20222023,8478420,Mikko Rantanen
75,36,56,92,0.142,0.2,20212022,8478420,Mikko Rantanen
52,30,36,66,0.169,0.41,20202021,8478420,Mikko Rantanen
42,19,22,41,0.178,,20192020,8478420,Mikko Rantanen
74,31,56,87,0.1606,,20182019,8478420,Mikko Rantanen
81,29,55,84,0.1629,,20172018,8478420,Mikko Rantanen
75,20,18,38,0.1504,,20162017,8478420,Mikko Rantanen
9,0,0,0,0.0,,20152016,8478420,Mikko Rantanen
82,35,45,80,0.165877,5.73,20242025,8480027,Jason Robertson
82,29,51,80,0.125541,5.79,20232024,8480027,Jason Robertson
82,46,63,109,0.146965,7.4,20222023,8480027,Jason Robertson
74,41,38,79,0.186,0.2,20212022,8480027,Jason Robertson
51,17,28,45,0.134,0.41,20202021,8480027,Jason Robertson
3,0,1,1,0.0,,20192020,8480027,Jason Robertson
20,9,12,21,0.195652,5.73,20242025,8475794,Tyler Seguin
68,25,27,52,0.162338,5.79,20232024,8475794,Tyler Seguin
76,21,29,50,0.111111,7.4,20222023,8475794,Tyler Seguin
81,24,25,49,0.11,0.2,20212022,8475794,Tyler Seguin
3,2,0,2,0.25,0.41,20202021,8475794,Tyler Seguin
69,17,33,50,0.069,,20192020,8475794,Tyler Seguin
82,33,47,80,0.0988,,20182019,8475794,Tyler Seguin
82,40,38,78,0.1194,,20172018,8475794,Tyler Seguin
82,26,46,72,0.0864,,20162017,8475794,Tyler Seguin
72,33,40,73,0.1187,,20152016,8475794,Tyler Seguin
71,37,40,77,0.1321,,20142015,8475794,Tyler Seguin
80,37,47,84,0.1259,,20132014,8475794,Tyler Seguin
48,16,16,32,0.0994,,20122013,8475794,Tyler Seguin
81,29,38,67,0.1198,,20112012,8475794,Tyler Seguin
74,11,11,22,0.084,,20102011,8475794,Tyler Seguin
79,6,19,25,0.067416,5.73,20242025,8479351,Sam Steel
77,9,15,24,0.104651,5.79,20232024,8479351,Sam Steel
65,10,18,28,0.117647,7.4,20222023,8479351,Sam Steel
68,6,14,20,0.091,0.2,20212022,8479351,Sam Steel
42,6,6,12,0.143,0.41,20202021,8479351,Sam Steel
65,6,16,22,0.071,,20192020,8479351,Sam Steel
22,6,5,11,0.1818,,20182019,8479351,Sam Steel
1,0,0,0,0.0,5.73,20242025,8478476,Kyle Capobianco
50,5,20,25,0.046296,5.73,20242025,8480036,Miro Heiskanen
71,9,45,54,0.055556,5.79,20232024,8480036,Miro Heiskanen
79,11,62,73,0.053398,7.4,20222023,8480036,Miro Heiskanen
70,5,31,36,0.032,0.2,20212022,8480036,Miro Heiskanen
55,8,19,27,0.066,0.41,20202021,8480036,Miro Heiskanen
68,8,27,35,0.049,,20192020,8480036,Miro Heiskanen
82,12,21,33,0.0659,,20182019,8480036,Miro Heiskanen
80,5,21,26,0.050505,5.73,20242025,8476902,Esa Lindell
82,5,21,26,0.04386,5.79,20232024,8476902,Esa Lindell
82,8,16,24,0.068966,7.4,20222023,8476902,Esa Lindell
76,4,21,25,0.029,0.2,20212022,8476902,Esa Lindell
56,5,11,16,0.05,0.41,20202021,8476902,Esa Lindell
69,3,20,23,0.031,,20192020,8476902,Esa Lindell
82,11,21,32,0.0833,,20182019,8476902,Esa Lindell
80,7,20,27,0.0511,,20172018,8476902,Esa Lindell
73,6,12,18,0.0606,,20162017,8476902,Esa Lindell
4,0,0,0,0.0,,20152016,8476902,Esa Lindell
80,1,13,14,0.019608,5.73,20242025,8480950,Ilya Lyubushkin
19,0,4,4,0.0,5.79,20232024,8480950,Ilya Lyubushkin
68,2,12,14,0.04878,7.4,20222023,8480950,Ilya Lyubushkin
31,2,4,6,0.095,0.2,20212022,8480950,Ilya Lyubushkin
42,1,1,2,0.028,0.41,20202021,8480950,Ilya Lyubushkin
51,0,4,4,0.0,,20192020,8480950,Ilya Lyubushkin
41,0,4,4,0.0,,20182019,8480950,Ilya Lyubushkin
5,0,0,0,0.0,5.73,20242025,8475755,Alexander Petrovic
1,0,0,0,0.0,5.79,20232024,8475755,Alexander Petrovic
71,10,12,22,0.093458,5.73,20242025,8478891,Mason Appleton
82,14,22,36,0.114754,5.79,20232024,8478891,Mason Appleton
41,5,11,16,0.070423,7.4,20222023,8478891,Mason Appleton
19,2,2,4,0.067,0.2,20212022,8478891,Mason Appleton
56,12,13,25,0.136,0.41,20202021,8478891,Mason Appleton
46,5,3,8,0.091,,20192020,8478891,Mason Appleton
36,3,7,10,0.1034,,20182019,8478891,Mason Appleton
76,11,21,32,0.112245,5.73,20242025,8477456,J.T. Compher
77,19,29,48,0.175926,5.79,20232024,8477456,J.T. Compher
82,17,35,52,0.11039,7.4,20222023,8477456,J.T. Compher
70,18,15,33,0.176,0.2,20212022,8477456,J.T. Compher
48,10,8,18,0.213,0.41,20202021,8477456,J.T. Compher
67,11,20,31,0.104,,20192020,8477456,J.T. Compher
66,16,16,32,0.1356,,20182019,8477456,J.T. Compher
69,13,10,23,0.0992,,20172018,8477456,J.T. Compher
21,3,2,5,0.1,,20162017,8477456,J.T. Compher
56,10,13,23,0.147059,5.73,20242025,8477429,Andrew Copp
79,13,20,33,0.119266,5.79,20232024,8477429,Andrew Copp
82,9,33,42,0.075,7.4,20222023,8477429,Andrew Copp
16,8,10,18,0.25,0.2,20212022,8477429,Andrew Copp
55,15,24,39,0.13,0.41,20202021,8477429,Andrew Copp
63,10,16,26,0.083,,20192020,8477429,Andrew Copp
69,11,14,25,0.1341,,20182019,8477429,Andrew Copp
82,9,19,28,0.0938,,20172018,8477429,Andrew Copp
64,9,8,17,0.1169,,20162017,8477429,Andrew Copp
77,7,6,13,0.1296,,20152016,8477429,Andrew Copp
1,0,1,1,0.0,,20142015,8477429,Andrew Copp
82,39,31,70,0.159836,5.73,20242025,8479337,Alex DeBrincat
82,27,40,67,0.113924,5.79,20232024,8479337,Alex DeBrincat
82,27,39,66,0.102662,7.4,20222023,8479337,Alex DeBrincat
82,41,37,78,0.152,0.2,20212022,8479337,Alex DeBrincat
52,32,24,56,0.206,0.41,20202021,8479337,Alex DeBrincat
70,18,27,45,0.087,,20192020,8479337,Alex DeBrincat
82,41,35,76,0.1864,,20182019,8479337,Alex DeBrincat
82,28,24,52,0.1547,,20172018,8479337,Alex DeBrincat
72,21,38,59,0.12,5.73,20242025,8474141,Patrick Kane
50,20,27,47,0.136054,5.79,20232024,8474141,Patrick Kane
19,5,7,12,0.111111,7.4,20222023,8474141,Patrick Kane
78,26,66,92,0.091,0.2,20212022,8474141,Patrick Kane
56,15,51,66,0.079,0.41,20202021,8474141,Patrick Kane
70,33,51,84,0.12,,20192020,8474141,Patrick Kane
81,44,66,110,0.129,,20182019,8474141,Patrick Kane
82,27,49,76,0.0947,,20172018,8474141,Patrick Kane
82,34,55,89,0.1164,,20162017,8474141,Patrick Kane
82,46,60,106,0.1603,,20152016,8474141,Patrick Kane
61,27,37,64,0.1452,,20142015,8474141,Patrick Kane
69,29,40,69,0.1278,,20132014,8474141,Patrick Kane
47,23,32,55,0.1667,,20122013,8474141,Patrick Kane
82,23,43,66,0.0909,,20112012,8474141,Patrick Kane
73,27,46,73,0.125,,20102011,8474141,Patrick Kane
82,30,58,88,0.1149,,20092010,8474141,Patrick Kane
80,25,45,70,0.0984,,20082009,8474141,Patrick Kane
82,21,51,72,0.1099,,20072008,8474141,Patrick Kane
82,30,40,70,0.128205,5.73,20242025,8477946,Dylan Larkin
68,33,36,69,0.149321,5.79,20232024,8477946,Dylan Larkin
80,32,47,79,0.131148,7.4,20222023,8477946,Dylan Larkin
71,31,38,69,0.146,0.2,20212022,8477946,Dylan Larkin
44,9,14,23,0.067,0.41,20202021,8477946,Dylan Larkin
71,19,34,53,0.085,,20192020,8477946,Dylan Larkin
76,32,41,73,0.1115,,20182019,8477946,Dylan Larkin
82,16,47,63,0.069,,20172018,8477946,Dylan Larkin
80,17,15,32,0.0955,,20162017,8477946,Dylan Larkin
80,23,22,45,0.1041,,20152016,8477946,Dylan Larkin
77,11,10,21,0.111111,5.73,20242025,8479992,Michael Rasmussen
75,13,20,33,0.128713,5.79,20232024,8479992,Michael Rasmussen
56,10,19,29,0.113636,7.4,20222023,8479992,Michael Rasmussen
80,15,12,27,0.117,0.2,20212022,8479992,Michael Rasmussen
40,3,9,12,0.048,0.41,20202021,8479992,Michael Rasmussen
71,16,20,36,0.188235,5.73,20242025,8474037,James van Riemsdyk
71,11,27,38,0.077465,5.79,20232024,8474037,James van Riemsdyk
61,12,17,29,0.10084,7.4,20222023,8474037,James van Riemsdyk
82,24,14,38,0.129,0.2,20212022,8474037,James van Riemsdyk
56,17,26,43,0.129,0.41,20202021,8474037,James van Riemsdyk
66,19,21,40,0.126,,20192020,8474037,James van Riemsdyk
66,27,21,48,0.1617,,20182019,8474037,James van Riemsdyk
81,36,18,54,0.1452,,20172018,8474037,James van Riemsdyk
82,29,33,62,0.1218,,20162017,8474037,James van Riemsdyk
40,14,15,29,0.1085,,20152016,8474037,James van Riemsdyk
82,27,29,56,0.1089,,20142015,8474037,James van Riemsdyk
80,30,31,61,0.1075,,20132014,8474037,James van Riemsdyk
48,18,14,32,0.1286,,20122013,8474037,James van Riemsdyk
43,11,13,24,0.0909,,20112012,8474037,James van Riemsdyk
75,21,19,40,0.1214,,20102011,8474037,James van Riemsdyk
78,15,20,35,0.0867,,20092010,8474037,James van Riemsdyk
13,3,0,3,0.230769,5.73,20242025,8475766,Austin Watson
33,2,2,4,0.117647,5.79,20232024,8475766,Austin Watson
75,9,2,11,0.113924,7.4,20222023,8475766,Austin Watson
67,10,6,16,0.114,0.2,20212022,8475766,Austin Watson
34,3,7,10,0.073,0.41,20202021,8475766,Austin Watson
53,6,8,14,0.12,,20192020,8475766,Austin Watson
37,7,9,16,0.1094,,20182019,8475766,Austin Watson
76,14,5,19,0.1458,,20172018,8475766,Austin Watson
77,5,12,17,0.0556,,20162017,8475766,Austin Watson
57,3,7,10,0.0545,,20152016,8475766,Austin Watson
15,1,3,4,0.071429,5.73,20242025,8480879,Jacob Bernard-Docker
72,4,10,14,0.078431,5.79,20232024,8480879,Jacob Bernard-Docker
19,0,1,1,0.0,7.4,20222023,8480879,Jacob Bernard-Docker
8,0,1,1,0.0,0.2,20212022,8480879,Jacob Bernard-Docker
5,0,0,0,0.0,0.41,20202021,8480879,Jacob Bernard-Docker
81,4,9,13,0.036697,5.73,20242025,8475279,Ben Chiarot
77,5,15,20,0.046729,5.79,20232024,8475279,Ben Chiarot
76,5,14,19,0.045455,7.4,20222023,8475279,Ben Chiarot
20,2,6,8,0.043,0.2,20212022,8475279,Ben Chiarot
41,1,6,7,0.012,0.41,20202021,8475279,Ben Chiarot
69,9,12,21,0.069,,20192020,8475279,Ben Chiarot
78,5,15,20,0.045,,20182019,8475279,Ben Chiarot
57,2,12,14,0.0351,,20172018,8475279,Ben Chiarot
59,2,10,12,0.0408,,20162017,8475279,Ben Chiarot
70,1,9,10,0.0135,,20152016,8475279,Ben Chiarot
40,2,6,8,0.0541,,20142015,8475279,Ben Chiarot
1,0,0,0,0.0,,20132014,8475279,Ben Chiarot
60,2,16,18,0.029851,5.73,20242025,8476979,Erik Gustafsson
76,6,25,31,0.064516,5.79,20232024,8476979,Erik Gustafsson
9,0,4,4,0.0,7.4,20222023,8476979,Erik Gustafsson
59,3,15,18,0.038,0.2,20212022,8476979,Erik Gustafsson
5,0,2,2,0.0,0.41,20202021,8476979,Erik Gustafsson
7,0,3,3,0.0,,20192020,8476979,Erik Gustafsson
79,17,43,60,0.1063,,20182019,8476979,Erik Gustafsson
35,5,11,16,0.0704,,20172018,8476979,Erik Gustafsson
59,1,6,7,0.013889,5.73,20242025,8474612,Travis Hamonic
48,2,4,6,0.04,5.79,20232024,8474612,Travis Hamonic
75,6,15,21,0.044118,7.4,20222023,8474612,Travis Hamonic
19,1,2,3,0.032,0.2,20212022,8474612,Travis Hamonic
38,3,7,10,0.038,0.41,20202021,8474612,Travis Hamonic
50,3,9,12,0.036,,20192020,8474612,Travis Hamonic
69,7,12,19,0.0547,,20182019,8474612,Travis Hamonic
74,1,10,11,0.0093,,20172018,8474612,Travis Hamonic
49,3,11,14,0.0405,,20162017,8474612,Travis Hamonic
72,5,16,21,0.034,,20152016,8474612,Travis Hamonic
71,5,28,33,0.0379,,20142015,8474612,Travis Hamonic
69,3,15,18,0.0224,,20132014,8474612,Travis Hamonic
48,3,7,10,0.0361,,20122013,8474612,Travis Hamonic
73,2,22,24,0.0161,,20112012,8474612,Travis Hamonic
62,5,21,26,0.0424,,20102011,8474612,Travis Hamonic
73,2,6,8,0.04878,5.73,20242025,8475718,Justin Holl
38,0,5,5,0.0,5.79,20232024,8475718,Justin Holl
80,2,16,18,0.033333,7.4,20222023,8475718,Justin Holl
69,3,20,23,0.047,0.2,20212022,8475718,Justin Holl
55,2,18,20,0.035,0.41,20202021,8475718,Justin Holl
68,2,16,18,0.022,,20192020,8475718,Justin Holl
11,0,1,1,0.0,,20182019,8475718,Justin Holl
2,2,0,2,1.0,,20172018,8475718,Justin Holl
7,0,1,1,0.0,5.73,20242025,8478021,William Lagesson
10,0,0,0,0.0,5.79,20232024,8478021,William Lagesson
15,0,1,1,0.0,5.73,20242025,8480070,Ian Mitchell
13,0,2,2,0.0,5.79,20232024,8480070,Ian Mitchell
35,1,7,8,0.04,7.4,20222023,8480070,Ian Mitchell
8,0,1,1,0.0,0.2,20212022,8480070,Ian Mitchell
39,3,4,7,0.13,0.41,20202021,8480070,Ian Mitchell
71,52,54,106,0.216667,5.73,20242025,8477934,Leon Draisaitl
81,41,65,106,0.18894,5.79,20232024,8477934,Leon Draisaitl
80,52,76,128,0.210526,7.4,20222023,8477934,Leon Draisaitl
80,55,55,110,0.198,0.2,20212022,8477934,Leon Draisaitl
56,31,53,84,0.185,0.41,20202021,8477934,Leon Draisaitl
71,43,67,110,0.197,,20192020,8477934,Leon Draisaitl
82,50,55,105,0.2165,,20182019,8477934,Leon Draisaitl
78,25,45,70,0.1289,,20172018,8477934,Leon Draisaitl
82,29,48,77,0.1686,,20162017,8477934,Leon Draisaitl
72,19,32,51,0.1429,,20152016,8477934,Leon Draisaitl
37,2,7,9,0.0408,,20142015,8477934,Leon Draisaitl
1,0,0,0,0.0,5.73,20242025,8479365,Trent Frederic
82,18,22,40,0.146341,5.79,20232024,8479365,Trent Frederic
79,17,14,31,0.141667,7.4,20222023,8479365,Trent Frederic
60,8,10,18,0.08,0.2,20212022,8479365,Trent Frederic
42,4,1,5,0.091,0.41,20202021,8479365,Trent Frederic
2,0,0,0,0.0,,20192020,8479365,Trent Frederic
15,0,0,0,0.0,,20182019,8479365,Trent Frederic
81,12,15,27,0.115385,5.73,20242025,8474641,Adam Henrique
22,6,3,9,0.206897,5.79,20232024,8474641,Adam Henrique
62,22,16,38,0.166667,7.4,20222023,8474641,Adam Henrique
58,19,23,42,0.135,0.2,20212022,8474641,Adam Henrique
45,12,9,21,0.156,0.41,20202021,8474641,Adam Henrique
71,26,17,43,0.154,,20192020,8474641,Adam Henrique
82,18,24,42,0.1475,,20182019,8474641,Adam Henrique
57,20,16,36,0.1961,,20172018,8474641,Adam Henrique
82,20,20,40,0.1408,,20162017,8474641,Adam Henrique
80,30,20,50,0.2013,,20152016,8474641,Adam Henrique
75,16,27,43,0.126,,20142015,8474641,Adam Henrique
77,25,18,43,0.1825,,20132014,8474641,Adam Henrique
42,11,5,16,0.141,,20122013,8474641,Adam Henrique
74,16,35,51,0.1231,,20112012,8474641,Adam Henrique
1,0,0,0,0.0,,20102011,8474641,Adam Henrique
73,27,17,44,0.128571,5.73,20242025,8475786,Zach Hyman
80,54,23,77,0.186207,5.79,20232024,8475786,Zach Hyman
79,36,47,83,0.130435,7.4,20222023,8475786,Zach Hyman
76,27,27,54,0.127,0.2,20212022,8475786,Zach Hyman
43,15,18,33,0.13,0.41,20202021,8475786,Zach Hyman
51,21,16,37,0.198,,20192020,8475786,Zach Hyman
71,21,20,41,0.1458,,20182019,8475786,Zach Hyman
82,15,25,40,0.1014,,20172018,8475786,Zach Hyman
82,10,18,28,0.0641,,20162017,8475786,Zach Hyman
16,4,2,6,0.1081,,20152016,8475786,Zach Hyman
80,2,16,18,0.039216,5.73,20242025,8477406,Mattias Janmark
71,4,8,12,0.059701,5.79,20232024,8477406,Mattias Janmark
66,10,15,25,0.126582,7.4,20222023,8477406,Mattias Janmark
67,9,16,25,0.101,0.2,20212022,8477406,Mattias Janmark
15,1,4,5,0.043,0.41,20202021,8477406,Mattias Janmark
62,6,15,21,0.07,,20192020,8477406,Mattias Janmark
81,6,19,25,0.0571,,20182019,8477406,Mattias Janmark
81,19,15,34,0.1397,,20172018,8477406,Mattias Janmark
19,1,1,2,0.066667,5.73,20242025,8479368,Max Jones
52,5,10,15,0.065789,5.79,20232024,8479368,Max Jones
69,9,10,19,0.084112,7.4,20222023,8479368,Max Jones
2,0,0,0,0.0,0.2,20212022,8479368,Max Jones
46,7,4,11,0.091,0.41,20202021,8479368,Max Jones
59,8,4,12,0.078,,20192020,8479368,Max Jones
30,2,3,5,0.0345,,20182019,8479368,Max Jones
57,5,8,13,0.090909,5.73,20242025,8477953,Kasperi Kapanen
73,6,16,22,0.060606,5.79,20232024,8477953,Kasperi Kapanen
23,8,6,14,0.170213,7.4,20222023,8477953,Kasperi Kapanen
79,11,21,32,0.085,0.2,20212022,8477953,Kasperi Kapanen
40,11,19,30,0.162,0.41,20202021,8477953,Kasperi Kapanen
69,13,23,36,0.107,,20192020,8477953,Kasperi Kapanen
78,20,24,44,0.1149,,20182019,8477953,Kasperi Kapanen
38,7,2,9,0.1273,,20172018,8477953,Kasperi Kapanen
8,1,0,1,0.0909,,20162017,8477953,Kasperi Kapanen
9,0,0,0,0.0,,20152016,8477953,Kasperi Kapanen
48,2,3,5,0.074074,5.73,20242025,8477508,Curtis Lazar
71,7,18,25,0.094595,5.79,20232024,8477508,Curtis Lazar
4,0,0,0,0.0,7.4,20222023,8477508,Curtis Lazar
70,8,8,16,0.084,0.2,20212022,8477508,Curtis Lazar
17,2,2,4,0.1,0.41,20202021,8477508,Curtis Lazar
38,5,5,10,0.152,,20192020,8477508,Curtis Lazar
1,0,0,0,0.0,,20182019,8477508,Curtis Lazar
65,2,10,12,0.0308,,20172018,8477508,Curtis Lazar
4,1,2,3,0.5,,20162017,8477508,Curtis Lazar
76,6,14,20,0.0769,,20152016,8477508,Curtis Lazar
67,6,9,15,0.0652,,20142015,8477508,Curtis Lazar
81,14,14,28,0.147368,5.73,20242025,8478233,Andrew Mangiapane
75,14,26,40,0.114754,5.79,20232024,8478233,Andrew Mangiapane
82,17,26,43,0.093407,7.4,20222023,8478233,Andrew Mangiapane
82,35,20,55,0.189,0.2,20212022,8478233,Andrew Mangiapane
56,18,14,32,0.198,0.41,20202021,8478233,Andrew Mangiapane
68,17,15,32,0.156,,20192020,8478233,Andrew Mangiapane
44,8,5,13,0.1231,,20182019,8478233,Andrew Mangiapane
10,0,0,0,0.0,,20172018,8478233,Andrew Mangiapane
67,26,74,100,0.132653,5.73,20242025,8478402,Connor McDavid
76,32,100,132,0.121673,5.79,20232024,8478402,Connor McDavid
82,64,89,153,0.181818,7.4,20222023,8478402,Connor McDavid
80,44,79,123,0.14,0.2,20212022,8478402,Connor McDavid
56,33,72,105,0.165,0.41,20202021,8478402,Connor McDavid
64,34,63,97,0.16,,20192020,8478402,Connor McDavid
78,41,75,116,0.1708,,20182019,8478402,Connor McDavid
82,41,67,108,0.1496,,20172018,8478402,Connor McDavid
82,30,70,100,0.1195,,20162017,8478402,Connor McDavid
45,16,32,48,0.1524,,20152016,8478402,Connor McDavid
78,20,29,49,0.121951,5.73,20242025,8476454,Ryan Nugent-Hopkins
80,18,49,67,0.098361,5.79,20232024,8476454,Ryan Nugent-Hopkins
82,37,67,104,0.18408,7.4,20222023,8476454,Ryan Nugent-Hopkins
63,11,39,50,0.071,0.2,20212022,8476454,Ryan Nugent-Hopkins
52,16,19,35,0.119,0.41,20202021,8476454,Ryan Nugent-Hopkins
65,22,39,61,0.128,,20192020,8476454,Ryan Nugent-Hopkins
82,28,41,69,0.1346,,20182019,8476454,Ryan Nugent-Hopkins
62,24,24,48,0.1589,,20172018,8476454,Ryan Nugent-Hopkins
82,18,25,43,0.09,,20162017,8476454,Ryan Nugent-Hopkins
55,12,22,34,0.1111,,20152016,8476454,Ryan Nugent-Hopkins
76,24,32,56,0.127,,20142015,8476454,Ryan Nugent-Hopkins
80,19,37,56,0.1067,,20132014,8476454,Ryan Nugent-Hopkins
40,4,20,24,0.0513,,20122013,8476454,Ryan Nugent-Hopkins
62,18,34,52,0.1343,,20112012,8476454,Ryan Nugent-Hopkins
82,14,53,67,0.059574,5.73,20242025,8480803,Evan Bouchard
81,18,64,82,0.081818,5.79,20232024,8480803,Evan Bouchard
82,8,32,40,0.051282,7.4,20222023,8480803,Evan Bouchard
81,12,31,43,0.059,0.2,20212022,8480803,Evan Bouchard
14,2,3,5,0.053,0.41,20202021,8480803,Evan Bouchard
10,0,1,1,0.0,5.73,20242025,8477384,Joshua Brown
51,3,7,10,0.068182,5.79,20232024,8477384,Joshua Brown
68,4,3,7,0.058824,7.4,20222023,8477384,Joshua Brown
6,0,0,0,0.0,0.2,20212022,8477384,Joshua Brown
26,0,1,1,0.0,0.41,20202021,8477384,Joshua Brown
56,3,5,8,0.063,,20192020,8477384,Joshua Brown
37,1,1,2,0.0357,,20182019,8477384,Joshua Brown
65,9,24,33,0.062937,5.73,20242025,8475218,Mattias Ekholm
79,11,34,45,0.062147,5.79,20232024,8475218,Mattias Ekholm
21,4,10,14,0.111111,7.4,20222023,8475218,Mattias Ekholm
76,6,25,31,0.041,0.2,20212022,8475218,Mattias Ekholm
48,6,17,23,0.055,0.41,20202021,8475218,Mattias Ekholm
68,8,25,33,0.052,,20192020,8475218,Mattias Ekholm
80,8,36,44,0.0548,,20182019,8475218,Mattias Ekholm
81,10,24,34,0.0741,,20172018,8475218,Mattias Ekholm
82,3,20,23,0.025,,20162017,8475218,Mattias Ekholm
82,8,27,35,0.0702,,20152016,8475218,Mattias Ekholm
80,7,11,18,0.0814,,20142015,8475218,Mattias Ekholm
62,1,8,9,0.0172,,20132014,8475218,Mattias Ekholm
1,0,0,0,0.0,,20122013,8475218,Mattias Ekholm
2,0,0,0,0.0,,20112012,8475218,Mattias Ekholm
82,7,18,25,0.051852,5.73,20242025,8476967,Brett Kulak
82,3,13,16,0.031915,5.79,20232024,8476967,Brett Kulak
82,3,17,20,0.026316,7.4,20222023,8476967,Brett Kulak
18,2,6,8,0.069,0.2,20212022,8476967,Brett Kulak
46,2,6,8,0.035,0.41,20202021,8476967,Brett Kulak
56,0,7,7,0.0,,20192020,8476967,Brett Kulak
57,6,11,17,0.0588,,20182019,8476967,Brett Kulak
71,2,6,8,0.0274,,20172018,8476967,Brett Kulak
21,0,3,3,0.0,,20162017,8476967,Brett Kulak
8,0,0,0,0.0,,20152016,8476967,Brett Kulak
1,0,0,0,0.0,,20142015,8476967,Brett Kulak
76,5,28,33,0.026596,5.73,20242025,8477498,Darnell Nurse
81,10,22,32,0.055249,5.79,20232024,8477498,Darnell Nurse
82,12,31,43,0.059113,7.4,20222023,8477498,Darnell Nurse
71,9,26,35,0.044,0.2,20212022,8477498,Darnell Nurse
56,16,20,36,0.104,0.41,20202021,8477498,Darnell Nurse
71,5,28,33,0.029,,20192020,8477498,Darnell Nurse
82,10,31,41,0.051,,20182019,8477498,Darnell Nurse
82,6,20,26,0.0309,,20172018,8477498,Darnell Nurse
44,5,6,11,0.0588,,20162017,8477498,Darnell Nurse
69,3,7,10,0.025,,20152016,8477498,Darnell Nurse
2,0,0,0,0.0,,20142015,8477498,Darnell Nurse
66,3,4,7,0.054545,5.73,20242025,8479442,Troy Stecher
7,0,2,2,0.0,5.79,20232024,8479442,Troy Stecher
20,3,4,7,0.115385,7.4,20222023,8479442,Troy Stecher
13,0,1,1,0.0,0.2,20212022,8479442,Troy Stecher
44,3,8,11,0.055,0.41,20202021,8479442,Troy Stecher
69,5,12,17,0.058,,20192020,8479442,Troy Stecher
78,2,21,23,0.019,,20182019,8479442,Troy Stecher
68,1,10,11,0.0106,,20172018,8479442,Troy Stecher
71,3,21,24,0.024,,20162017,8479442,Troy Stecher
5,0,0,0,0.0,5.73,20242025,8479388,Riley Stillman
15,1,7,8,0.025641,5.73,20242025,8478013,Jake Walman
63,12,9,21,0.111111,5.79,20232024,8478013,Jake Walman
63,9,9,18,0.064286,7.4,20222023,8478013,Jake Walman
19,0,4,4,0.0,0.2,20212022,8478013,Jake Walman
24,1,1,2,0.021,0.41,20202021,8478013,Jake Walman
1,0,0,0,0.0,,20192020,8478013,Jake Walman
67,20,51,71,0.134228,5.73,20242025,8477493,Aleksander Barkov
73,23,57,80,0.119171,5.79,20232024,8477493,Aleksander Barkov
68,23,55,78,0.110577,7.4,20222023,8477493,Aleksander Barkov
67,39,49,88,0.182,0.2,20212022,8477493,Aleksander Barkov
50,26,32,58,0.148,0.41,20202021,8477493,Aleksander Barkov
66,20,42,62,0.116,,20192020,8477493,Aleksander Barkov
82,35,61,96,0.1699,,20182019,8477493,Aleksander Barkov
79,27,51,78,0.1055,,20172018,8477493,Aleksander Barkov
61,21,31,52,0.1479,,20162017,8477493,Aleksander Barkov
66,28,31,59,0.1637,,20152016,8477493,Aleksander Barkov
71,16,20,36,0.1301,,20142015,8477493,Aleksander Barkov
54,8,16,24,0.092,,20132014,8477493,Aleksander Barkov
76,25,26,51,0.103734,5.73,20242025,8477935,Sam Bennett
69,20,21,41,0.116959,5.79,20232024,8477935,Sam Bennett
63,16,24,40,0.082902,7.4,20222023,8477935,Sam Bennett
71,28,21,49,0.116,0.2,20212022,8477935,Sam Bennett
10,6,9,15,0.154,0.41,20202021,8477935,Sam Bennett
52,8,4,12,0.098,,20192020,8477935,Sam Bennett
71,13,14,27,0.113,,20182019,8477935,Sam Bennett
82,11,15,26,0.0701,,20172018,8477935,Sam Bennett
81,13,13,26,0.1066,,20162017,8477935,Sam Bennett
77,18,18,36,0.1324,,20152016,8477935,Sam Bennett
1,0,1,1,0.0,,20142015,8477935,Sam Bennett
78,12,11,23,0.137931,5.73,20242025,8480003,Jesper Boqvist
47,6,8,14,0.117647,5.79,20232024,8480003,Jesper Boqvist
70,10,11,21,0.149254,7.4,20222023,8480003,Jesper Boqvist
56,10,13,23,0.135,0.2,20212022,8480003,Jesper Boqvist
28,4,3,7,0.118,0.41,20202021,8480003,Jesper Boqvist
35,4,0,4,0.098,,20192020,8480003,Jesper Boqvist
7,0,1,1,0.0,5.73,20242025,8481518,Nolan Foote
4,1,0,1,0.166667,5.79,20232024,8481518,Nolan Foote
6,1,0,1,0.25,7.4,20222023,8481518,Nolan Foote
7,3,1,4,0.3,0.2,20212022,8481518,Nolan Foote
6,1,1,2,0.2,0.41,20202021,8481518,Nolan Foote
42,4,0,4,0.093023,5.73,20242025,8479981,Jonah Gadjovich
39,2,2,4,0.068966,5.79,20232024,8479981,Jonah Gadjovich
35,3,4,7,0.09375,7.4,20222023,8479981,Jonah Gadjovich
43,1,2,3,0.028,0.2,20212022,8479981,Jonah Gadjovich
1,0,0,0,0.0,0.41,20202021,8479981,Jonah Gadjovich
81,6,11,17,0.069767,5.73,20242025,8478421,A.J. Greer
59,6,6,12,0.105263,5.79,20232024,8478421,A.J. Greer
61,5,7,12,0.075758,7.4,20222023,8478421,A.J. Greer
9,1,1,2,0.071,0.2,20212022,8478421,A.J. Greer
1,0,0,0,0.0,0.41,20202021,8478421,A.J. Greer
12,0,0,0,0.0,5.73,20242025,8479316,Luke Kunin
77,11,7,18,0.112245,5.79,20232024,8479316,Luke Kunin
31,5,8,13,0.086207,7.4,20222023,8479316,Luke Kunin
82,13,9,22,0.104,0.2,20212022,8479316,Luke Kunin
38,10,9,19,0.141,0.41,20202021,8479316,Luke Kunin
63,15,16,31,0.117,,20192020,8479316,Luke Kunin
49,6,11,17,0.0682,,20182019,8479316,Luke Kunin
19,2,2,4,0.0625,,20172018,8479316,Luke Kunin
80,9,15,24,0.103448,5.73,20242025,8480185,Eetu Luostarinen
82,12,15,27,0.10084,5.79,20232024,8480185,Eetu Luostarinen
82,17,26,43,0.128788,7.4,20222023,8480185,Eetu Luostarinen
78,9,17,26,0.107,0.2,20212022,8480185,Eetu Luostarinen
44,3,5,8,0.088,0.41,20202021,8480185,Eetu Luostarinen
8,0,1,1,0.0,,20192020,8480185,Eetu Luostarinen
10,2,2,4,0.105263,5.73,20242025,8473419,Brad Marchand
82,29,38,67,0.140097,5.79,20232024,8473419,Brad Marchand
73,21,46,67,0.114754,7.4,20222023,8473419,Brad Marchand
70,32,48,80,0.132,0.2,20212022,8473419,Brad Marchand
53,29,40,69,0.203,0.41,20202021,8473419,Brad Marchand
70,28,59,87,0.151,,20192020,8473419,Brad Marchand
79,36,64,100,0.1558,,20182019,8473419,Brad Marchand
68,34,51,85,0.1868,,20172018,8473419,Brad Marchand
80,39,46,85,0.1726,,20162017,8473419,Brad Marchand
77,37,24,61,0.148,,20152016,8473419,Brad Marchand
77,24,18,42,0.1333,,20142015,8473419,Brad Marchand
82,25,28,53,0.1678,,20132014,8473419,Brad Marchand
45,18,18,36,0.1978,,20122013,8473419,Brad Marchand
76,28,27,55,0.1677,,20112012,8473419,Brad Marchand
77,21,20,41,0.1409,,20102011,8473419,Brad Marchand
20,0,1,1,0.0,,20092010,8473419,Brad Marchand
59,1,8,9,0.021277,5.73,20242025,8477931,Tomas Nosek
36,2,4,6,0.052632,5.79,20232024,8477931,Tomas Nosek
66,7,11,18,0.101449,7.4,20222023,8477931,Tomas Nosek
75,3,14,17,0.036,0.2,20212022,8477931,Tomas Nosek
38,8,10,18,0.136,0.41,20202021,8477931,Tomas Nosek
67,8,7,15,0.086,,20192020,8477931,Tomas Nosek
68,8,9,17,0.069,,20182019,8477931,Tomas Nosek
67,7,8,15,0.0761,,20172018,8477931,Tomas Nosek
11,1,0,1,0.0526,,20162017,8477931,Tomas Nosek
6,0,0,0,0.0,,20152016,8477931,Tomas Nosek
79,39,42,81,0.183099,5.73,20242025,8477933,Sam Reinhart
82,57,37,94,0.244635,5.79,20232024,8477933,Sam Reinhart
82,31,36,67,0.136564,7.4,20222023,8477933,Sam Reinhart
78,33,49,82,0.177,0.2,20212022,8477933,Sam Reinhart
54,25,15,40,0.192,0.41,20202021,8477933,Sam Reinhart
69,22,28,50,0.153,,20192020,8477933,Sam Reinhart
82,22,43,65,0.1222,,20182019,8477933,Sam Reinhart
82,25,25,50,0.133,,20172018,8477933,Sam Reinhart
79,17,30,47,0.0955,,20162017,8477933,Sam Reinhart
79,23,19,42,0.1394,,20152016,8477933,Sam Reinhart
9,0,1,1,0.0,,20142015,8477933,Sam Reinhart
82,15,17,32,0.093168,5.73,20242025,8478542,Evan Rodrigues
80,12,27,39,0.064516,5.79,20232024,8478542,Evan Rodrigues
69,16,23,39,0.086957,7.4,20222023,8478542,Evan Rodrigues
82,19,24,43,0.078,0.2,20212022,8478542,Evan Rodrigues
35,7,7,14,0.108,0.41,20202021,8478542,Evan Rodrigues
7,1,0,1,0.091,,20192020,8478542,Evan Rodrigues
74,9,20,29,0.0536,,20182019,8478542,Evan Rodrigues
48,7,18,25,0.0769,,20172018,8478542,Evan Rodrigues
30,4,2,6,0.0784,,20162017,8478542,Evan Rodrigues
2,1,1,2,0.125,,20152016,8478542,Evan Rodrigues
52,22,35,57,0.141026,5.73,20242025,8479314,Matthew Tkachuk
80,26,62,88,0.092857,5.79,20232024,8479314,Matthew Tkachuk
79,40,69,109,0.124224,7.4,20222023,8479314,Matthew Tkachuk
82,42,62,104,0.166,0.2,20212022,8479314,Matthew Tkachuk
56,16,27,43,0.106,0.41,20202021,8479314,Matthew Tkachuk
69,23,38,61,0.122,,20192020,8479314,Matthew Tkachuk
80,34,43,77,0.1643,,20182019,8479314,Matthew Tkachuk
68,24,25,49,0.1277,,20172018,8479314,Matthew Tkachuk
76,13,35,48,0.0915,,20162017,8479314,Matthew Tkachuk
81,20,33,53,0.082645,5.73,20242025,8477409,Carter Verhaeghe
76,34,38,72,0.138211,5.79,20232024,8477409,Carter Verhaeghe
81,42,31,73,0.152727,7.4,20222023,8477409,Carter Verhaeghe
78,24,31,55,0.144,0.2,20212022,8477409,Carter Verhaeghe
43,18,18,36,0.168,0.41,20202021,8477409,Carter Verhaeghe
52,9,4,13,0.158,,20192020,8477409,Carter Verhaeghe
14,0,0,0,0.0,5.73,20242025,8481600,Tobias Bjornfot
1,0,0,0,0.0,5.79,20232024,8481600,Tobias Bjornfot
10,0,1,1,0.0,7.4,20222023,8481600,Tobias Bjornfot
70,0,8,8,0.0,0.2,20212022,8481600,Tobias Bjornfot
33,1,5,6,0.033,0.41,20202021,8481600,Tobias Bjornfot
3,0,0,0,0.0,,20192020,8481600,Tobias Bjornfot
56,3,30,33,0.028302,5.73,20242025,8477932,Aaron Ekblad
51,4,14,18,0.040816,5.79,20232024,8477932,Aaron Ekblad
71,14,24,38,0.064815,7.4,20222023,8477932,Aaron Ekblad
61,15,42,57,0.083,0.2,20212022,8477932,Aaron Ekblad
35,11,11,22,0.109,0.41,20202021,8477932,Aaron Ekblad
67,5,36,41,0.034,,20192020,8477932,Aaron Ekblad
82,13,24,37,0.0722,,20182019,8477932,Aaron Ekblad
82,16,22,38,0.0847,,20172018,8477932,Aaron Ekblad
68,10,11,21,0.0444,,20162017,8477932,Aaron Ekblad
78,15,21,36,0.0824,,20152016,8477932,Aaron Ekblad
81,12,27,39,0.0706,,20142015,8477932,Aaron Ekblad
80,11,20,31,0.05641,5.73,20242025,8478055,Gustav Forsling
79,10,29,39,0.0625,5.79,20232024,8478055,Gustav Forsling
82,13,28,41,0.062201,7.4,20222023,8478055,Gustav Forsling
71,10,27,37,0.069,0.2,20212022,8478055,Gustav Forsling
43,5,12,17,0.053,0.41,20202021,8478055,Gustav Forsling
21,2,7,9,0.041667,5.73,20242025,8477495,Seth Jones
67,8,23,31,0.046512,5.79,20232024,8477495,Seth Jones
72,12,25,37,0.067416,7.4,20222023,8477495,Seth Jones
78,5,46,51,0.026,0.2,20212022,8477495,Seth Jones
56,5,23,28,0.035,0.41,20202021,8477495,Seth Jones
56,6,24,30,0.048,,20192020,8477495,Seth Jones
75,9,37,46,0.0489,,20182019,8477495,Seth Jones
78,16,41,57,0.0643,,20172018,8477495,Seth Jones
75,12,30,42,0.0789,,20162017,8477495,Seth Jones
41,2,18,20,0.0241,,20152016,8477495,Seth Jones
82,8,19,27,0.065,,20142015,8477495,Seth Jones
77,6,19,25,0.06,,20132014,8477495,Seth Jones
70,4,9,13,0.0625,5.73,20242025,8475179,Dmitry Kulikov
76,1,19,20,0.013514,5.79,20232024,8475179,Dmitry Kulikov
6,0,1,1,0.0,7.4,20222023,8475179,Dmitry Kulikov
80,7,17,24,0.095,0.2,20212022,8475179,Dmitry Kulikov
10,0,2,2,0.0,0.41,20202021,8475179,Dmitry Kulikov
51,2,8,10,0.037,,20192020,8475179,Dmitry Kulikov
57,0,6,6,0.0,,20182019,8475179,Dmitry Kulikov
62,3,8,11,0.0625,,20172018,8475179,Dmitry Kulikov
47,2,3,5,0.0476,,20162017,8475179,Dmitry Kulikov
74,1,16,17,0.0101,,20152016,8475179,Dmitry Kulikov
73,3,19,22,0.0361,,20142015,8475179,Dmitry Kulikov
81,8,11,19,0.063,,20132014,8475179,Dmitry Kulikov
34,3,7,10,0.0577,,20122013,8475179,Dmitry Kulikov
58,4,24,28,0.0385,,20112012,8475179,Dmitry Kulikov
72,6,20,26,0.0723,,20102011,8475179,Dmitry Kulikov
68,3,13,16,0.0345,,20092010,8475179,Dmitry Kulikov
76,6,16,22,0.051724,5.73,20242025,8478859,Niko Mikkola
82,3,14,17,0.032258,5.79,20232024,8478859,Niko Mikkola
31,1,2,3,0.032258,7.4,20222023,8478859,Niko Mikkola
54,3,10,13,0.052,0.2,20212022,8478859,Niko Mikkola
30,1,2,3,0.045,0.41,20202021,8478859,Niko Mikkola
5,0,1,1,0.0,,20192020,8478859,Niko Mikkola
44,1,7,8,0.030303,5.73,20242025,8473507,Jeff Petry
73,3,21,24,0.035714,5.79,20232024,8473507,Jeff Petry
61,5,26,31,0.044248,7.4,20222023,8473507,Jeff Petry
68,6,21,27,0.048,0.2,20212022,8473507,Jeff Petry
55,12,30,42,0.094,0.41,20202021,8473507,Jeff Petry
71,11,29,40,0.07,,20192020,8473507,Jeff Petry
82,13,33,46,0.0756,,20182019,8473507,Jeff Petry
82,12,30,42,0.0674,,20172018,8473507,Jeff Petry
80,8,20,28,0.0465,,20162017,8473507,Jeff Petry
51,5,11,16,0.051,,20152016,8473507,Jeff Petry
19,3,4,7,0.1304,,20142015,8473507,Jeff Petry
80,7,10,17,0.0729,,20132014,8473507,Jeff Petry
48,3,9,12,0.0455,,20122013,8473507,Jeff Petry
73,2,23,25,0.018,,20112012,8473507,Jeff Petry
35,1,4,5,0.0244,,20102011,8473507,Jeff Petry
81,11,18,29,0.105769,5.73,20242025,8476469,Joel Armia
66,17,8,25,0.122302,5.79,20232024,8476469,Joel Armia
43,7,7,14,0.101449,7.4,20222023,8476469,Joel Armia
60,6,8,14,0.058,0.2,20212022,8476469,Joel Armia
41,7,7,14,0.096,0.41,20202021,8476469,Joel Armia
58,16,14,30,0.103,,20192020,8476469,Joel Armia
57,13,10,23,0.097,,20182019,8476469,Joel Armia
79,12,17,29,0.0938,,20172018,8476469,Joel Armia
57,10,9,19,0.0901,,20162017,8476469,Joel Armia
43,4,6,10,0.0769,,20152016,8476469,Joel Armia
1,0,0,0,0.0,,20142015,8476469,Joel Armia
81,23,31,54,0.146497,5.73,20242025,8482124,Quinton Byfield
80,20,35,55,0.124224,5.79,20232024,8482124,Quinton Byfield
53,3,19,22,0.040541,7.4,20222023,8482124,Quinton Byfield
40,5,5,10,0.128,0.2,20212022,8482124,Quinton Byfield
6,0,1,1,0.0,0.41,20202021,8482124,Quinton Byfield
80,8,35,43,0.065041,5.73,20242025,8476479,Phillip Danault
78,17,30,47,0.106918,5.79,20232024,8476479,Phillip Danault
82,18,36,54,0.118421,7.4,20222023,8476479,Phillip Danault
79,27,24,51,0.139,0.2,20212022,8476479,Phillip Danault
53,5,19,24,0.068,0.41,20202021,8476479,Phillip Danault
71,13,34,47,0.099,,20192020,8476479,Phillip Danault
81,12,41,53,0.0909,,20182019,8476479,Phillip Danault
52,8,17,25,0.0851,,20172018,8476479,Phillip Danault
82,13,27,40,0.0977,,20162017,8476479,Phillip Danault
21,3,2,5,0.125,,20152016,8476479,Phillip Danault
2,0,0,0,0.0,,20142015,8476479,Phillip Danault
81,35,25,60,0.143443,5.73,20242025,8477942,Kevin Fiala
82,29,44,73,0.128889,5.79,20232024,8477942,Kevin Fiala
69,23,49,72,0.110577,7.4,20222023,8477942,Kevin Fiala
82,33,52,85,0.126,0.2,20212022,8477942,Kevin Fiala
50,20,20,40,0.123,0.41,20202021,8477942,Kevin Fiala
64,23,31,54,0.131,,20192020,8477942,Kevin Fiala
19,3,4,7,0.0698,,20182019,8477942,Kevin Fiala
80,23,25,48,0.123,,20172018,8477942,Kevin Fiala
54,11,5,16,0.0965,,20162017,8477942,Kevin Fiala
5,1,0,1,0.0909,,20152016,8477942,Kevin Fiala
1,0,0,0,0.0,,20142015,8477942,Kevin Fiala
82,24,22,46,0.120603,5.73,20242025,8477998,Warren Foegele
82,20,21,41,0.099502,5.79,20232024,8477998,Warren Foegele
67,13,15,28,0.103175,7.4,20222023,8477998,Warren Foegele
82,12,14,26,0.085,0.2,20212022,8477998,Warren Foegele
53,10,10,20,0.11,0.41,20202021,8477998,Warren Foegele
68,13,17,30,0.101,,20192020,8477998,Warren Foegele
77,10,5,15,0.0943,,20182019,8477998,Warren Foegele
2,2,1,3,0.3333,,20172018,8477998,Warren Foegele
81,35,38,73,0.147679,5.73,20242025,8477960,Adrian Kempe
77,28,47,75,0.113821,5.79,20232024,8477960,Adrian Kempe
82,41,26,67,0.164,7.4,20222023,8477960,Adrian Kempe
78,35,19,54,0.142,0.2,20212022,8477960,Adrian Kempe
56,14,15,29,0.11,0.41,20202021,8477960,Adrian Kempe
69,11,21,32,0.074,,20192020,8477960,Adrian Kempe
81,12,16,28,0.1017,,20182019,8477960,Adrian Kempe
81,16,21,37,0.1345,,20172018,8477960,Adrian Kempe
25,2,4,6,0.0625,,20162017,8477960,Adrian Kempe
81,21,46,67,0.214286,5.73,20242025,8471685,Anze Kopitar
81,26,44,70,0.195489,5.79,20232024,8471685,Anze Kopitar
82,28,46,74,0.16568,7.4,20222023,8471685,Anze Kopitar
81,19,48,67,0.09,0.2,20212022,8471685,Anze Kopitar
56,13,37,50,0.11,0.41,20202021,8471685,Anze Kopitar
70,21,41,62,0.156,,20192020,8471685,Anze Kopitar
81,22,38,60,0.141,,20182019,8471685,Anze Kopitar
82,35,57,92,0.175,,20172018,8471685,Anze Kopitar
76,12,40,52,0.08,,20162017,8471685,Anze Kopitar
81,25,49,74,0.1412,,20152016,8471685,Anze Kopitar
79,16,48,64,0.1194,,20142015,8471685,Anze Kopitar
82,29,41,70,0.145,,20132014,8471685,Anze Kopitar
47,10,32,42,0.102,,20122013,8471685,Anze Kopitar
82,25,51,76,0.1087,,20112012,8471685,Anze Kopitar
75,25,48,73,0.1073,,20102011,8471685,Anze Kopitar
82,34,47,81,0.1313,,20092010,8471685,Anze Kopitar
82,27,39,66,0.1154,,20082009,8471685,Anze Kopitar
82,32,45,77,0.1592,,20072008,8471685,Anze Kopitar
72,20,41,61,0.1036,,20062007,8471685,Anze Kopitar
71,18,22,40,0.117647,5.73,20242025,8479675,Trevor Moore
82,31,26,57,0.127049,5.79,20232024,8479675,Trevor Moore
59,10,19,29,0.06135,7.4,20222023,8479675,Trevor Moore
81,17,31,48,0.084,0.2,20212022,8479675,Trevor Moore
56,10,13,23,0.114,0.41,20202021,8479675,Trevor Moore
15,3,2,5,0.158,,20192020,8479675,Trevor Moore
25,2,6,8,0.0769,,20182019,8479675,Trevor Moore
81,19,11,30,0.19,5.73,20242025,8470621,Corey Perry
38,8,5,13,0.142857,5.79,20232024,8470621,Corey Perry
81,12,13,25,0.103448,7.4,20222023,8470621,Corey Perry
82,19,21,40,0.124,0.2,20212022,8470621,Corey Perry
49,9,12,21,0.145,0.41,20202021,8470621,Corey Perry
57,5,16,21,0.065,,20192020,8470621,Corey Perry
31,6,4,10,0.1017,,20182019,8470621,Corey Perry
71,17,32,49,0.1012,,20172018,8470621,Corey Perry
82,19,34,53,0.0884,,20162017,8470621,Corey Perry
82,34,28,62,0.1581,,20152016,8470621,Corey Perry
67,33,22,55,0.171,,20142015,8470621,Corey Perry
81,43,39,82,0.1536,,20132014,8470621,Corey Perry
44,15,21,36,0.1172,,20122013,8470621,Corey Perry
80,37,23,60,0.1336,,20112012,8470621,Corey Perry
82,50,48,98,0.1724,,20102011,8470621,Corey Perry
82,27,49,76,0.1,,20092010,8470621,Corey Perry
78,32,40,72,0.1131,,20082009,8470621,Corey Perry
70,29,25,54,0.145,,20072008,8470621,Corey Perry
82,17,27,44,0.0876,,20062007,8470621,Corey Perry
56,13,12,25,0.1327,,20052006,8470621,Corey Perry
77,6,18,24,0.071429,5.73,20242025,8479998,Mikey Anderson
74,2,16,18,0.022472,5.79,20232024,8479998,Mikey Anderson
77,5,15,20,0.055556,7.4,20222023,8479998,Mikey Anderson
57,2,6,8,0.034,0.2,20212022,8479998,Mikey Anderson
54,1,10,11,0.019,0.41,20202021,8479998,Mikey Anderson
6,1,0,1,0.111,,20192020,8479998,Mikey Anderson
33,0,3,3,0.0,5.73,20242025,8477335,Kyle Burroughs
73,2,6,8,0.025316,5.79,20232024,8477335,Kyle Burroughs
48,2,3,5,0.042553,7.4,20222023,8477335,Kyle Burroughs
42,1,4,5,0.026,0.2,20212022,8477335,Kyle Burroughs
5,0,1,1,0.0,0.41,20202021,8477335,Kyle Burroughs
31,0,9,9,0.0,5.73,20242025,8476879,Cody Ceci
79,5,20,25,0.051546,5.79,20232024,8476879,Cody Ceci
80,1,14,15,0.011364,7.4,20222023,8476879,Cody Ceci
78,5,23,28,0.049,0.2,20212022,8476879,Cody Ceci
53,4,13,17,0.069,0.41,20202021,8476879,Cody Ceci
56,1,7,8,0.021,,20192020,8476879,Cody Ceci
74,7,19,26,0.053,,20182019,8476879,Cody Ceci
82,5,14,19,0.035,,20172018,8476879,Cody Ceci
79,2,15,17,0.014,,20162017,8476879,Cody Ceci
75,10,16,26,0.0862,,20152016,8476879,Cody Ceci
81,5,16,21,0.0385,,20142015,8476879,Cody Ceci
49,3,6,9,0.0366,,20132014,8476879,Cody Ceci
30,4,13,17,0.086957,5.73,20242025,8474563,Drew Doughty
82,15,35,50,0.111111,5.79,20232024,8474563,Drew Doughty
81,9,43,52,0.062069,7.4,20222023,8474563,Drew Doughty
39,7,24,31,0.071,0.2,20212022,8474563,Drew Doughty
56,8,26,34,0.079,0.41,20202021,8474563,Drew Doughty
67,7,28,35,0.05,,20192020,8474563,Drew Doughty
82,8,37,45,0.0519,,20182019,8474563,Drew Doughty
82,10,50,60,0.0488,,20172018,8474563,Drew Doughty
82,12,32,44,0.0663,,20162017,8474563,Drew Doughty
82,14,37,51,0.0711,,20152016,8474563,Drew Doughty
82,7,39,46,0.032,,20142015,8474563,Drew Doughty
78,10,27,37,0.0565,,20132014,8474563,Drew Doughty
48,6,16,22,0.0526,,20122013,8474563,Drew Doughty
77,10,26,36,0.0595,,20112012,8474563,Drew Doughty
76,11,29,40,0.0791,,20102011,8474563,Drew Doughty
82,16,43,59,0.1127,,20092010,8474563,Drew Doughty
81,6,21,27,0.0476,,20082009,8474563,Drew Doughty
19,1,5,6,0.083333,5.73,20242025,8475208,Brian Dumoulin
80,6,10,16,0.086957,5.79,20232024,8475208,Brian Dumoulin
82,1,24,25,0.012195,7.4,20222023,8475208,Brian Dumoulin
76,3,15,18,0.033,0.2,20212022,8475208,Brian Dumoulin
41,4,10,14,0.08,0.41,20202021,8475208,Brian Dumoulin
28,1,7,8,0.029,,20192020,8475208,Brian Dumoulin
76,3,20,23,0.0303,,20182019,8475208,Brian Dumoulin
80,5,13,18,0.049,,20172018,8475208,Brian Dumoulin
70,1,14,15,0.0128,,20162017,8475208,Brian Dumoulin
79,0,16,16,0.0,,20152016,8475208,Brian Dumoulin
8,1,0,1,0.25,,20142015,8475208,Brian Dumoulin
6,0,1,1,0.0,,20132014,8475208,Brian Dumoulin
73,6,14,20,0.065934,5.73,20242025,8476441,Joel Edmundson
9,0,0,0,0.0,5.79,20232024,8476441,Joel Edmundson
61,2,11,13,0.028986,7.4,20222023,8476441,Joel Edmundson
24,3,3,6,0.094,0.2,20212022,8476441,Joel Edmundson
55,3,10,13,0.039,0.41,20202021,8476441,Joel Edmundson
68,7,13,20,0.072,,20192020,8476441,Joel Edmundson
64,2,9,11,0.0196,,20182019,8476441,Joel Edmundson
69,7,10,17,0.0565,,20172018,8476441,Joel Edmundson
69,3,12,15,0.037,,20162017,8476441,Joel Edmundson
67,1,8,9,0.0111,,20152016,8476441,Joel Edmundson
3,0,0,0,0.0,5.73,20242025,8477979,Nicolas Aube-Kubel
60,6,10,16,0.103448,5.79,20232024,8477979,Nicolas Aube-Kubel
47,4,8,12,0.061538,7.4,20222023,8477979,Nicolas Aube-Kubel
67,11,11,22,0.141,0.2,20212022,8477979,Nicolas Aube-Kubel
50,3,9,12,0.057,0.41,20202021,8477979,Nicolas Aube-Kubel
36,7,8,15,0.146,,20192020,8477979,Nicolas Aube-Kubel
9,0,0,0,0.0,,20182019,8477979,Nicolas Aube-Kubel
46,14,15,29,0.1,5.73,20242025,8478493,Joel Eriksson Ek
77,30,34,64,0.11236,5.79,20232024,8478493,Joel Eriksson Ek
78,23,38,61,0.093117,7.4,20222023,8478493,Joel Eriksson Ek
77,26,23,49,0.117,0.2,20212022,8478493,Joel Eriksson Ek
56,19,11,30,0.16,0.41,20202021,8478493,Joel Eriksson Ek
62,8,21,29,0.078,,20192020,8478493,Joel Eriksson Ek
58,7,7,14,0.0631,,20182019,8478493,Joel Eriksson Ek
75,6,10,16,0.0484,,20172018,8478493,Joel Eriksson Ek
15,3,4,7,0.2,,20162017,8478493,Joel Eriksson Ek
77,14,15,29,0.153846,5.73,20242025,8475220,Marcus Foligno
55,10,12,22,0.178571,5.79,20232024,8475220,Marcus Foligno
65,7,14,21,0.084337,7.4,20222023,8475220,Marcus Foligno
74,23,19,42,0.235,0.2,20212022,8475220,Marcus Foligno
39,11,15,26,0.275,0.41,20202021,8475220,Marcus Foligno
59,11,14,25,0.128,,20192020,8475220,Marcus Foligno
82,7,12,19,0.0769,,20182019,8475220,Marcus Foligno
77,8,15,23,0.1013,,20172018,8475220,Marcus Foligno
80,13,10,23,0.134,,20162017,8475220,Marcus Foligno
75,10,13,23,0.1235,,20152016,8475220,Marcus Foligno
57,8,12,20,0.1212,,20142015,8475220,Marcus Foligno
74,7,12,19,0.0886,,20132014,8475220,Marcus Foligno
47,5,13,18,0.0909,,20122013,8475220,Marcus Foligno
14,6,7,13,0.2609,,20112012,8475220,Marcus Foligno
69,11,15,26,0.06962,5.73,20242025,8477451,Ryan Hartman
74,21,24,45,0.121387,5.79,20232024,8477451,Ryan Hartman
59,15,22,37,0.100671,7.4,20222023,8477451,Ryan Hartman
82,34,31,65,0.142,0.2,20212022,8477451,Ryan Hartman
51,7,15,22,0.095,0.41,20202021,8477451,Ryan Hartman
69,9,11,20,0.079,,20192020,8477451,Ryan Hartman
19,2,4,6,0.0625,,20182019,8477451,Ryan Hartman
21,3,3,6,0.0909,,20172018,8477451,Ryan Hartman
76,19,12,31,0.1118,,20162017,8477451,Ryan Hartman
3,0,1,1,0.0,,20152016,8477451,Ryan Hartman
5,0,0,0,0.0,,20142015,8477451,Ryan Hartman
25,5,3,8,0.135135,5.73,20242025,8476994,Vinnie Hinostroza
14,1,2,3,0.037037,5.79,20232024,8476994,Vinnie Hinostroza
26,2,9,11,0.052632,7.4,20222023,8476994,Vinnie Hinostroza
62,13,12,25,0.141,0.2,20212022,8476994,Vinnie Hinostroza
17,4,8,12,0.148,0.41,20202021,8476994,Vinnie Hinostroza
68,5,17,22,0.038,,20192020,8476994,Vinnie Hinostroza
72,16,23,39,0.1053,,20182019,8476994,Vinnie Hinostroza
50,7,18,25,0.0814,,20172018,8476994,Vinnie Hinostroza
49,6,8,14,0.0789,,20162017,8476994,Vinnie Hinostroza
7,0,0,0,0.0,,20152016,8476994,Vinnie Hinostroza
72,11,23,34,0.090909,5.73,20242025,8475149,Marcus Johansson
78,11,19,30,0.098214,5.79,20232024,8475149,Marcus Johansson
20,6,12,18,0.142857,7.4,20222023,8475149,Marcus Johansson
18,3,3,6,0.1,0.2,20212022,8475149,Marcus Johansson
36,6,8,14,0.13,0.41,20202021,8475149,Marcus Johansson
60,9,21,30,0.103,,20192020,8475149,Marcus Johansson
10,1,2,3,0.0833,,20182019,8475149,Marcus Johansson
29,5,9,14,0.119,,20172018,8475149,Marcus Johansson
82,24,34,58,0.186,,20162017,8475149,Marcus Johansson
74,17,29,46,0.1288,,20152016,8475149,Marcus Johansson
82,20,27,47,0.1449,,20142015,8475149,Marcus Johansson
80,8,36,44,0.0748,,20132014,8475149,Marcus Johansson
34,6,16,22,0.15,,20122013,8475149,Marcus Johansson
80,14,32,46,0.1556,,20112012,8475149,Marcus Johansson
69,13,14,27,0.1275,,20102011,8475149,Marcus Johansson
41,25,31,56,0.172414,5.73,20242025,8478864,Kirill Kaprizov
75,46,50,96,0.166065,5.79,20232024,8478864,Kirill Kaprizov
67,40,35,75,0.153257,7.4,20222023,8478864,Kirill Kaprizov
81,47,61,108,0.163,0.2,20212022,8478864,Kirill Kaprizov
55,27,24,51,0.172,0.41,20202021,8478864,Kirill Kaprizov
15,0,1,1,0.0,5.73,20242025,8481477,Nico Sturm
63,5,8,13,0.072464,5.79,20232024,8481477,Nico Sturm
74,14,12,26,0.117647,7.4,20222023,8481477,Nico Sturm
21,0,3,3,0.0,0.2,20212022,8481477,Nico Sturm
50,11,6,17,0.172,0.41,20202021,8481477,Nico Sturm
6,0,2,2,0.0,,20192020,8481477,Nico Sturm
2,0,0,0,0.0,,20182019,8481477,Nico Sturm
80,11,22,33,0.082707,5.73,20242025,8475765,Vladimir Tarasenko
19,6,8,14,0.153846,5.79,20232024,8475765,Vladimir Tarasenko
31,8,13,21,0.121212,7.4,20222023,8475765,Vladimir Tarasenko
75,34,48,82,0.148,0.2,20212022,8475765,Vladimir Tarasenko
24,4,10,14,0.062,0.41,20202021,8475765,Vladimir Tarasenko
10,3,7,10,0.115,,20192020,8475765,Vladimir Tarasenko
76,33,35,68,0.12,,20182019,8475765,Vladimir Tarasenko
80,33,33,66,0.1078,,20172018,8475765,Vladimir Tarasenko
82,39,36,75,0.1364,,20162017,8475765,Vladimir Tarasenko
80,40,34,74,0.137,,20152016,8475765,Vladimir Tarasenko
77,37,36,73,0.1402,,20142015,8475765,Vladimir Tarasenko
64,21,22,43,0.1544,,20132014,8475765,Vladimir Tarasenko
38,8,11,19,0.1067,,20122013,8475765,Vladimir Tarasenko
76,7,8,15,0.082353,5.73,20242025,8478508,Yakov Trenin
16,2,1,3,0.090909,5.79,20232024,8478508,Yakov Trenin
77,12,12,24,0.085714,7.4,20222023,8478508,Yakov Trenin
80,17,7,24,0.125,0.2,20212022,8478508,Yakov Trenin
45,5,6,11,0.081,0.41,20202021,8478508,Yakov Trenin
21,2,4,6,0.08,,20192020,8478508,Yakov Trenin
69,19,35,54,0.125828,5.73,20242025,8475692,Mats Zuccarello
69,12,51,63,0.069364,5.79,20232024,8475692,Mats Zuccarello
78,22,45,67,0.111111,7.4,20222023,8475692,Mats Zuccarello
70,24,55,79,0.151,0.2,20212022,8475692,Mats Zuccarello
42,11,24,35,0.149,0.41,20202021,8475692,Mats Zuccarello
65,15,22,37,0.156,,20192020,8475692,Mats Zuccarello
2,1,2,3,0.2,,20182019,8475692,Mats Zuccarello
80,16,37,53,0.0899,,20172018,8475692,Mats Zuccarello
80,15,44,59,0.0794,,20162017,8475692,Mats Zuccarello
81,26,35,61,0.1566,,20152016,8475692,Mats Zuccarello
78,15,34,49,0.0974,,20142015,8475692,Mats Zuccarello
77,19,40,59,0.1118,,20132014,8475692,Mats Zuccarello
15,3,5,8,0.1111,,20122013,8475692,Mats Zuccarello
10,2,1,3,0.2,,20112012,8475692,Mats Zuccarello
42,6,17,23,0.0811,,20102011,8475692,Mats Zuccarello
81,4,12,16,0.050633,5.73,20242025,8474567,Zach Bogosian
61,3,11,14,0.038961,5.79,20232024,8474567,Zach Bogosian
46,1,4,5,0.018519,7.4,20222023,8474567,Zach Bogosian
48,3,5,8,0.05,0.2,20212022,8474567,Zach Bogosian
45,0,4,4,0.0,0.41,20202021,8474567,Zach Bogosian
8,0,2,2,0.0,,20192020,8474567,Zach Bogosian
65,3,16,19,0.0323,,20182019,8474567,Zach Bogosian
18,0,1,1,0.0,,20172018,8474567,Zach Bogosian
56,2,9,11,0.0274,,20162017,8474567,Zach Bogosian
64,7,17,24,0.0579,,20152016,8474567,Zach Bogosian
21,0,7,7,0.0,,20142015,8474567,Zach Bogosian
55,3,8,11,0.0224,,20132014,8474567,Zach Bogosian
33,5,9,14,0.0588,,20122013,8474567,Zach Bogosian
65,5,25,30,0.0333,,20112012,8474567,Zach Bogosian
71,5,12,17,0.0323,,20102011,8474567,Zach Bogosian
81,10,13,23,0.0645,,20092010,8474567,Zach Bogosian
47,9,10,19,0.1,,20082009,8474567,Zach Bogosian
50,4,16,20,0.056338,5.73,20242025,8476463,Jonas Brodin
62,7,20,27,0.059829,5.79,20232024,8476463,Jonas Brodin
60,3,11,14,0.033333,7.4,20222023,8476463,Jonas Brodin
73,5,25,30,0.04,0.2,20212022,8476463,Jonas Brodin
53,9,14,23,0.114,0.41,20202021,8476463,Jonas Brodin
69,2,26,28,0.019,,20192020,8476463,Jonas Brodin
82,4,14,18,0.036,,20182019,8476463,Jonas Brodin
73,6,15,21,0.0779,,20172018,8476463,Jonas Brodin
68,3,22,25,0.0353,,20162017,8476463,Jonas Brodin
68,2,5,7,0.0345,,20152016,8476463,Jonas Brodin
71,3,14,17,0.0316,,20142015,8476463,Jonas Brodin
79,8,11,19,0.1081,,20132014,8476463,Jonas Brodin
45,2,9,11,0.0392,,20122013,8476463,Jonas Brodin
67,8,13,21,0.082474,5.73,20242025,8478136,Jake Middleton
80,7,18,25,0.082353,5.79,20232024,8478136,Jake Middleton
79,3,12,15,0.037975,7.4,20222023,8478136,Jake Middleton
21,1,4,5,0.045,0.2,20212022,8478136,Jake Middleton
1,0,0,0,0.0,0.41,20202021,8478136,Jake Middleton
10,0,2,2,0.0,,20192020,8478136,Jake Middleton
3,0,1,1,0.0,,20182019,8478136,Jake Middleton
66,7,25,32,0.065421,5.73,20242025,8474716,Jared Spurgeon
16,0,5,5,0.0,5.79,20232024,8474716,Jared Spurgeon
79,11,23,34,0.073826,7.4,20222023,8474716,Jared Spurgeon
65,10,30,40,0.086,0.2,20212022,8474716,Jared Spurgeon
54,7,18,25,0.074,0.41,20202021,8474716,Jared Spurgeon
62,12,20,32,0.107,,20192020,8474716,Jared Spurgeon
82,14,29,43,0.0921,,20182019,8474716,Jared Spurgeon
61,9,28,37,0.0818,,20172018,8474716,Jared Spurgeon
76,10,28,38,0.0694,,20162017,8474716,Jared Spurgeon
77,11,18,29,0.0902,,20152016,8474716,Jared Spurgeon
66,9,16,25,0.0703,,20142015,8474716,Jared Spurgeon
67,5,21,26,0.0549,,20132014,8474716,Jared Spurgeon
39,5,10,15,0.0746,,20122013,8474716,Jared Spurgeon
70,3,20,23,0.0326,,20112012,8474716,Jared Spurgeon
53,4,8,12,0.1053,,20102011,8474716,Jared Spurgeon
81,15,12,27,0.137615,5.73,20242025,8476981,Josh Anderson
78,9,11,20,0.06383,5.79,20232024,8476981,Josh Anderson
69,21,11,32,0.128049,7.4,20222023,8476981,Josh Anderson
69,19,13,32,0.126,0.2,20212022,8476981,Josh Anderson
52,17,7,24,0.136,0.41,20202021,8476981,Josh Anderson
26,1,3,4,0.016,,20192020,8476981,Josh Anderson
82,27,20,47,0.1174,,20182019,8476981,Josh Anderson
63,19,11,30,0.1011,,20172018,8476981,Josh Anderson
78,17,12,29,0.1429,,20162017,8476981,Josh Anderson
12,1,3,4,0.0909,,20152016,8476981,Josh Anderson
6,0,1,1,0.0,,20142015,8476981,Josh Anderson
82,37,33,70,0.154167,5.73,20242025,8481540,Cole Caufield
82,28,37,65,0.089172,5.79,20232024,8481540,Cole Caufield
46,26,10,36,0.164557,7.4,20222023,8481540,Cole Caufield
67,23,20,43,0.122,0.2,20212022,8481540,Cole Caufield
10,4,1,5,0.133,0.41,20202021,8481540,Cole Caufield
57,10,12,22,0.119048,5.73,20242025,8481523,Kirby Dach
2,0,2,2,0.0,5.79,20232024,8481523,Kirby Dach
58,14,24,38,0.130841,7.4,20222023,8481523,Kirby Dach
70,9,17,26,0.078,0.2,20212022,8481523,Kirby Dach
18,2,8,10,0.077,0.41,20202021,8481523,Kirby Dach
64,8,15,23,0.079,,20192020,8481523,Kirby Dach
82,13,23,36,0.1625,5.73,20242025,8478133,Jake Evans
82,7,21,28,0.08642,5.79,20232024,8478133,Jake Evans
54,2,17,19,0.036364,7.4,20222023,8478133,Jake Evans
72,13,16,29,0.105,0.2,20212022,8478133,Jake Evans
47,3,10,13,0.055,0.41,20202021,8478133,Jake Evans
13,2,1,3,0.143,,20192020,8478133,Jake Evans
82,21,17,38,0.141892,5.73,20242025,8475848,Brendan Gallagher
77,16,15,31,0.103896,5.79,20232024,8475848,Brendan Gallagher
37,8,6,14,0.086022,7.4,20222023,8475848,Brendan Gallagher
56,7,17,24,0.049,0.2,20212022,8475848,Brendan Gallagher
35,14,9,23,0.132,0.41,20202021,8475848,Brendan Gallagher
59,22,21,43,0.097,,20192020,8475848,Brendan Gallagher
82,33,19,52,0.1093,,20182019,8475848,Brendan Gallagher
82,31,23,54,0.1115,,20172018,8475848,Brendan Gallagher
64,10,19,29,0.0535,,20162017,8475848,Brendan Gallagher
53,19,21,40,0.1098,,20152016,8475848,Brendan Gallagher
82,24,23,47,0.0945,,20142015,8475848,Brendan Gallagher
81,19,22,41,0.09,,20132014,8475848,Brendan Gallagher
44,15,13,28,0.1282,,20122013,8475848,Brendan Gallagher
52,20,13,33,0.172414,5.73,20242025,8479339,Patrik Laine
18,6,3,9,0.146341,5.79,20232024,8479339,Patrik Laine
55,22,30,52,0.119565,7.4,20222023,8479339,Patrik Laine
56,26,30,56,0.156,0.2,20212022,8479339,Patrik Laine
45,10,11,21,0.127,0.41,20202021,8479339,Patrik Laine
68,28,35,63,0.124,,20192020,8479339,Patrik Laine
82,30,20,50,0.1224,,20182019,8479339,Patrik Laine
82,44,26,70,0.1826,,20172018,8479339,Patrik Laine
73,36,28,64,0.1765,,20162017,8479339,Patrik Laine
82,15,11,26,0.127119,5.73,20242025,8481618,Alex Newhook
55,15,19,34,0.176471,5.79,20232024,8481618,Alex Newhook
82,14,16,30,0.12069,7.4,20222023,8481618,Alex Newhook
71,13,20,33,0.115,0.2,20212022,8481618,Alex Newhook
6,0,3,3,0.0,0.41,20202021,8481618,Alex Newhook
82,30,59,89,0.174419,5.73,20242025,8480018,Nick Suzuki
82,33,44,77,0.178378,5.79,20232024,8480018,Nick Suzuki
82,26,40,66,0.160494,7.4,20222023,8480018,Nick Suzuki
82,21,40,61,0.113,0.2,20212022,8480018,Nick Suzuki
56,15,26,41,0.136,0.41,20202021,8480018,Nick Suzuki
71,13,28,41,0.094,,20192020,8480018,Nick Suzuki
18,3,4,7,0.12,5.73,20242025,8480813,Joe Veleno
80,12,16,28,0.139535,5.79,20232024,8480813,Joe Veleno
81,9,11,20,0.105882,7.4,20222023,8480813,Joe Veleno
66,8,7,15,0.11,0.2,20212022,8480813,Joe Veleno
5,1,0,1,0.125,0.41,20202021,8480813,Joe Veleno
51,2,16,18,0.033898,5.73,20242025,8478851,Alexandre Carrier
73,4,16,20,0.051948,5.79,20232024,8478851,Alexandre Carrier
43,2,7,9,0.041667,7.4,20222023,8478851,Alexandre Carrier
77,3,27,30,0.032,0.2,20212022,8478851,Alexandre Carrier
19,1,2,3,0.032,0.41,20202021,8478851,Alexandre Carrier
3,0,0,0,0.0,,20192020,8478851,Alexandre Carrier
71,10,29,39,0.05102,5.73,20242025,8480865,Noah Dobson
79,10,60,70,0.057471,5.79,20232024,8480865,Noah Dobson
78,13,36,49,0.063107,7.4,20222023,8480865,Noah Dobson
80,13,38,51,0.068,0.2,20212022,8480865,Noah Dobson
46,3,11,14,0.043,0.41,20202021,8480865,Noah Dobson
34,1,6,7,0.027,,20192020,8480865,Noah Dobson
80,6,25,31,0.040268,5.73,20242025,8476875,Mike Matheson
82,11,51,62,0.058824,5.79,20232024,8476875,Mike Matheson
48,8,26,34,0.063492,7.4,20222023,8476875,Mike Matheson
74,11,20,31,0.079,0.2,20212022,8476875,Mike Matheson
44,5,11,16,0.058,0.41,20202021,8476875,Mike Matheson
59,8,12,20,0.077,,20192020,8476875,Mike Matheson
75,8,19,27,0.062,,20182019,8476875,Mike Matheson
81,10,17,27,0.0599,,20172018,8476875,Mike Matheson
81,7,10,17,0.0391,,20162017,8476875,Mike Matheson
3,0,0,0,0.0,,20152016,8476875,Mike Matheson
81,21,67,88,0.116667,5.73,20242025,8479407,Jesper Bratt
82,27,56,83,0.108871,5.79,20232024,8479407,Jesper Bratt
82,32,41,73,0.150943,7.4,20222023,8479407,Jesper Bratt
76,26,47,73,0.132,0.2,20212022,8479407,Jesper Bratt
46,7,23,30,0.069,0.41,20202021,8479407,Jesper Bratt
60,16,16,32,0.158,,20192020,8479407,Jesper Bratt
51,8,25,33,0.0879,,20182019,8479407,Jesper Bratt
74,13,22,35,0.13,,20172018,8479407,Jesper Bratt
82,13,17,30,0.105691,5.73,20242025,8477015,Connor Brown
71,4,8,12,0.037037,5.79,20232024,8477015,Connor Brown
4,0,0,0,0.0,7.4,20222023,8477015,Connor Brown
64,10,29,39,0.083,0.2,20212022,8477015,Connor Brown
56,21,14,35,0.171,0.41,20202021,8477015,Connor Brown
71,16,27,43,0.092,,20192020,8477015,Connor Brown
82,8,21,29,0.0941,,20182019,8477015,Connor Brown
82,14,14,28,0.1176,,20172018,8477015,Connor Brown
82,20,16,36,0.1439,,20162017,8477015,Connor Brown
7,1,5,6,0.0909,,20152016,8477015,Connor Brown
80,20,20,40,0.162602,5.73,20242025,8474149,Evgenii Dadonov
51,12,11,23,0.179104,5.79,20232024,8474149,Evgenii Dadonov
23,3,12,15,0.078947,7.4,20222023,8474149,Evgenii Dadonov
78,20,23,43,0.113,0.2,20212022,8474149,Evgenii Dadonov
55,13,7,20,0.146,0.41,20202021,8474149,Evgenii Dadonov
69,25,22,47,0.15,,20192020,8474149,Evgenii Dadonov
82,28,42,70,0.1436,,20182019,8474149,Evgenii Dadonov
74,28,37,65,0.1489,,20172018,8474149,Evgenii Dadonov
14,2,5,7,0.153846,5.73,20242025,8479996,Cody Glass
41,6,7,13,0.073171,5.79,20232024,8479996,Cody Glass
72,14,21,35,0.10687,7.4,20222023,8479996,Cody Glass
8,0,1,1,0.0,0.2,20212022,8479996,Cody Glass
27,4,6,10,0.143,0.41,20202021,8479996,Cody Glass
39,5,7,12,0.098,,20192020,8479996,Cody Glass
75,35,34,69,0.187166,5.73,20242025,8480002,Nico Hischier
71,27,40,67,0.148352,5.79,20232024,8480002,Nico Hischier
81,31,49,80,0.121094,7.4,20222023,8480002,Nico Hischier
70,21,39,60,0.137,0.2,20212022,8480002,Nico Hischier
21,6,5,11,0.136,0.41,20202021,8480002,Nico Hischier
58,14,22,36,0.114,,20192020,8480002,Nico Hischier
69,17,30,47,0.1063,,20182019,8480002,Nico Hischier
82,20,32,52,0.1111,,20172018,8480002,Nico Hischier
62,27,43,70,0.117904,5.73,20242025,8481559,Jack Hughes
62,27,47,74,0.09854,5.79,20232024,8481559,Jack Hughes
78,43,56,99,0.127976,7.4,20222023,8481559,Jack Hughes
49,26,30,56,0.158,0.2,20212022,8481559,Jack Hughes
56,11,20,31,0.077,0.41,20202021,8481559,Jack Hughes
61,7,14,21,0.057,,20192020,8481559,Jack Hughes
23,0,0,0,0.0,5.73,20242025,8477073,Kurtis MacDermid
16,0,1,1,0.0,5.79,20232024,8477073,Kurtis MacDermid
44,1,5,6,0.05,7.4,20222023,8477073,Kurtis MacDermid
58,2,3,5,0.043,0.2,20212022,8477073,Kurtis MacDermid
28,2,2,4,0.125,0.41,20202021,8477073,Kurtis MacDermid
45,3,5,8,0.059,,20192020,8477073,Kurtis MacDermid
11,0,1,1,0.0,,20182019,8477073,Kurtis MacDermid
34,1,3,4,0.0526,,20172018,8477073,Kurtis MacDermid
80,26,27,53,0.108787,5.73,20242025,8478414,Timo Meier
69,28,24,52,0.135266,5.79,20232024,8478414,Timo Meier
21,9,5,14,0.125,7.4,20222023,8478414,Timo Meier
77,35,41,76,0.107,0.2,20212022,8478414,Timo Meier
54,12,19,31,0.077,0.41,20202021,8478414,Timo Meier
70,22,27,49,0.111,,20192020,8478414,Timo Meier
78,30,36,66,0.12,,20182019,8478414,Timo Meier
81,21,15,36,0.1,,20172018,8478414,Timo Meier
34,3,3,6,0.0353,,20162017,8478414,Timo Meier
78,22,19,41,0.133333,5.73,20242025,8476474,Stefan Noesen
81,14,23,37,0.126126,5.79,20232024,8476474,Stefan Noesen
78,13,23,36,0.097015,7.4,20222023,8476474,Stefan Noesen
2,0,0,0,0.0,0.2,20212022,8476474,Stefan Noesen
1,0,0,0,0.0,0.41,20202021,8476474,Stefan Noesen
34,6,2,8,0.102,,20192020,8476474,Stefan Noesen
41,3,5,8,0.0469,,20182019,8476474,Stefan Noesen
72,13,14,27,0.1024,,20172018,8476474,Stefan Noesen
32,6,2,8,0.1176,,20162017,8476474,Stefan Noesen
1,0,0,0,0.0,,20152016,8476474,Stefan Noesen
1,0,0,0,0.0,,20142015,8476474,Stefan Noesen
77,15,13,28,0.15625,5.73,20242025,8476292,Ondrej Palat
71,11,20,31,0.101852,5.79,20232024,8476292,Ondrej Palat
49,8,15,23,0.101266,7.4,20222023,8476292,Ondrej Palat
77,18,31,49,0.126,0.2,20212022,8476292,Ondrej Palat
55,15,31,46,0.135,0.41,20202021,8476292,Ondrej Palat
69,17,24,41,0.133,,20192020,8476292,Ondrej Palat
64,8,26,34,0.08,,20182019,8476292,Ondrej Palat
56,11,24,35,0.1009,,20172018,8476292,Ondrej Palat
75,17,35,52,0.1049,,20162017,8476292,Ondrej Palat
62,16,24,40,0.1368,,20152016,8476292,Ondrej Palat
75,16,47,63,0.1151,,20142015,8476292,Ondrej Palat
81,23,36,59,0.1394,,20132014,8476292,Ondrej Palat
14,2,2,4,0.125,,20122013,8476292,Ondrej Palat
6,0,0,0,0.0,5.73,20242025,8479395,Dennis Cholowski
82,2,14,16,0.041667,5.73,20242025,8475455,Brenden Dillon
77,8,12,20,0.101266,5.79,20232024,8475455,Brenden Dillon
82,2,21,23,0.024096,7.4,20222023,8475455,Brenden Dillon
79,3,17,20,0.035,0.2,20212022,8475455,Brenden Dillon
56,2,17,19,0.039,0.41,20202021,8475455,Brenden Dillon
10,0,0,0,0.0,,20192020,8475455,Brenden Dillon
82,1,21,22,0.0141,,20182019,8475455,Brenden Dillon
81,5,17,22,0.0568,,20172018,8475455,Brenden Dillon
81,2,8,10,0.0233,,20162017,8475455,Brenden Dillon
76,2,9,11,0.0215,,20152016,8475455,Brenden Dillon
60,2,7,9,0.0267,,20142015,8475455,Brenden Dillon
80,6,11,17,0.0619,,20132014,8475455,Brenden Dillon
48,3,5,8,0.04,,20122013,8475455,Brenden Dillon
1,0,0,0,0.0,,20112012,8475455,Brenden Dillon
64,9,31,40,0.048387,5.73,20242025,8476462,Dougie Hamilton
20,5,11,16,0.081967,5.79,20232024,8476462,Dougie Hamilton
82,22,52,74,0.08,7.4,20222023,8476462,Dougie Hamilton
62,9,21,30,0.046,0.2,20212022,8476462,Dougie Hamilton
55,10,32,42,0.056,0.41,20202021,8476462,Dougie Hamilton
47,14,26,40,0.082,,20192020,8476462,Dougie Hamilton
82,18,21,39,0.0695,,20182019,8476462,Dougie Hamilton
82,17,27,44,0.063,,20172018,8476462,Dougie Hamilton
81,13,37,50,0.0586,,20162017,8476462,Dougie Hamilton
82,12,31,43,0.0632,,20152016,8476462,Dougie Hamilton
72,10,32,42,0.0532,,20142015,8476462,Dougie Hamilton
64,7,18,25,0.0614,,20132014,8476462,Dougie Hamilton
42,5,11,16,0.0602,,20122013,8476462,Dougie Hamilton
72,3,14,17,0.030303,5.73,20242025,8477488,Brett Pesce
70,3,10,13,0.028037,5.79,20232024,8477488,Brett Pesce
82,5,25,30,0.034722,7.4,20222023,8477488,Brett Pesce
70,7,21,28,0.047,0.2,20212022,8477488,Brett Pesce
55,4,21,25,0.045,0.41,20202021,8477488,Brett Pesce
61,4,14,18,0.038,,20192020,8477488,Brett Pesce
73,7,22,29,0.0714,,20182019,8477488,Brett Pesce
65,3,16,19,0.0341,,20172018,8477488,Brett Pesce
82,2,18,20,0.0183,,20162017,8477488,Brett Pesce
69,4,12,16,0.0471,,20152016,8477488,Brett Pesce
55,2,7,9,0.038462,5.73,20242025,8478399,Jonas Siegenthaler
57,1,8,9,0.015873,5.79,20232024,8478399,Jonas Siegenthaler
80,4,17,21,0.047619,7.4,20222023,8478399,Jonas Siegenthaler
70,1,13,14,0.011,0.2,20212022,8478399,Jonas Siegenthaler
8,0,0,0,0.0,0.41,20202021,8478399,Jonas Siegenthaler
64,2,7,9,0.041,,20192020,8478399,Jonas Siegenthaler
26,0,4,4,0.0,,20182019,8478399,Jonas Siegenthaler
18,5,4,9,0.111111,5.73,20242025,8478047,Michael Bunting
21,6,13,19,0.109091,5.79,20232024,8478047,Michael Bunting
82,23,26,49,0.132184,7.4,20222023,8478047,Michael Bunting
79,23,40,63,0.131,0.2,20212022,8478047,Michael Bunting
21,10,3,13,0.263,0.41,20202021,8478047,Michael Bunting
82,31,45,76,0.11032,5.73,20242025,8476887,Filip Forsberg
82,48,46,94,0.138329,5.79,20232024,8476887,Filip Forsberg
50,19,23,42,0.121019,7.4,20222023,8476887,Filip Forsberg
69,42,42,84,0.186,0.2,20212022,8476887,Filip Forsberg
39,12,20,32,0.093,0.41,20202021,8476887,Filip Forsberg
63,21,27,48,0.106,,20192020,8476887,Filip Forsberg
64,28,22,50,0.129,,20182019,8476887,Filip Forsberg
67,26,38,64,0.1453,,20172018,8476887,Filip Forsberg
82,31,27,58,0.1325,,20162017,8476887,Filip Forsberg
82,33,31,64,0.1336,,20152016,8476887,Filip Forsberg
82,26,37,63,0.1097,,20142015,8476887,Filip Forsberg
13,1,4,5,0.05,,20132014,8476887,Filip Forsberg
5,0,1,1,0.0,,20122013,8476887,Filip Forsberg
69,11,10,21,0.1,5.73,20242025,8475287,Erik Haula
76,16,19,35,0.103226,5.79,20232024,8475287,Erik Haula
80,14,27,41,0.085366,7.4,20222023,8475287,Erik Haula
78,18,26,44,0.128,0.2,20212022,8475287,Erik Haula
51,9,12,21,0.106,0.41,20202021,8475287,Erik Haula
7,0,2,2,0.0,,20192020,8475287,Erik Haula
15,2,5,7,0.0769,,20182019,8475287,Erik Haula
76,29,26,55,0.1657,,20172018,8475287,Erik Haula
72,15,11,26,0.1119,,20162017,8475287,Erik Haula
76,14,20,34,0.1414,,20152016,8475287,Erik Haula
72,7,7,14,0.0761,,20142015,8475287,Erik Haula
46,6,9,15,0.1071,,20132014,8475287,Erik Haula
78,21,35,56,0.101942,5.73,20242025,8476539,Jonathan Marchessault
82,42,27,69,0.157895,5.79,20232024,8476539,Jonathan Marchessault
76,28,29,57,0.119658,7.4,20222023,8476539,Jonathan Marchessault
76,30,36,66,0.12,0.2,20212022,8476539,Jonathan Marchessault
55,18,26,44,0.102,0.41,20202021,8476539,Jonathan Marchessault
66,22,25,47,0.094,,20192020,8476539,Jonathan Marchessault
82,25,34,59,0.0899,,20182019,8476539,Jonathan Marchessault
77,27,48,75,0.1007,,20172018,8476539,Jonathan Marchessault
75,30,21,51,0.1554,,20162017,8476539,Jonathan Marchessault
45,7,11,18,0.0864,,20152016,8476539,Jonathan Marchessault
2,1,0,1,0.3333,,20142015,8476539,Jonathan Marchessault
74,5,9,14,0.0625,5.73,20242025,8477446,Michael McCarron
70,12,10,22,0.12766,5.79,20232024,8477446,Michael McCarron
32,2,2,4,0.051282,7.4,20222023,8477446,Michael McCarron
51,7,7,14,0.137,0.2,20212022,8477446,Michael McCarron
6,0,0,0,0.0,0.41,20202021,8477446,Michael McCarron
79,21,32,53,0.139073,5.73,20242025,8475158,Ryan O'Reilly
82,26,43,69,0.144444,5.79,20232024,8475158,Ryan O'Reilly
13,4,7,11,0.181818,7.4,20222023,8475158,Ryan O'Reilly
78,21,37,58,0.125,0.2,20212022,8475158,Ryan O'Reilly
56,24,30,54,0.186,0.41,20202021,8475158,Ryan O'Reilly
71,12,49,61,0.102,,20192020,8475158,Ryan O'Reilly
82,28,49,77,0.1197,,20182019,8475158,Ryan O'Reilly
81,24,37,61,0.1043,,20172018,8475158,Ryan O'Reilly
72,20,35,55,0.1058,,20162017,8475158,Ryan O'Reilly
71,21,39,60,0.1338,,20152016,8475158,Ryan O'Reilly
82,17,38,55,0.0994,,20142015,8475158,Ryan O'Reilly
80,28,36,64,0.1393,,20132014,8475158,Ryan O'Reilly
29,6,14,20,0.0909,,20122013,8475158,Ryan O'Reilly
81,18,37,55,0.0952,,20112012,8475158,Ryan O'Reilly
74,13,13,26,0.1092,,20102011,8475158,Ryan O'Reilly
81,8,18,26,0.0593,,20092010,8475158,Ryan O'Reilly
71,4,8,12,0.057971,5.73,20242025,8482062,Cole Smith
80,9,14,23,0.080357,5.79,20232024,8482062,Cole Smith
69,4,13,17,0.0625,7.4,20222023,8482062,Cole Smith
8,0,0,0,0.0,0.2,20212022,8482062,Cole Smith
1,0,0,0,0.0,0.41,20202021,8482062,Cole Smith
82,27,26,53,0.155172,5.73,20242025,8474564,Steven Stamkos
79,40,41,81,0.152672,5.79,20232024,8474564,Steven Stamkos
81,34,50,84,0.141667,7.4,20222023,8474564,Steven Stamkos
81,42,64,106,0.174,0.2,20212022,8474564,Steven Stamkos
38,17,17,34,0.187,0.41,20202021,8474564,Steven Stamkos
57,29,37,66,0.165,,20192020,8474564,Steven Stamkos
82,45,53,98,0.1923,,20182019,8474564,Steven Stamkos
78,27,59,86,0.1274,,20172018,8474564,Steven Stamkos
17,9,11,20,0.1552,,20162017,8474564,Steven Stamkos
77,36,28,64,0.1667,,20152016,8474564,Steven Stamkos
82,43,29,72,0.1604,,20142015,8474564,Steven Stamkos
37,25,15,40,0.2016,,20132014,8474564,Steven Stamkos
48,29,28,57,0.1847,,20122013,8474564,Steven Stamkos
82,60,37,97,0.198,,20112012,8474564,Steven Stamkos
82,45,46,91,0.1654,,20102011,8474564,Steven Stamkos
82,51,44,95,0.1717,,20092010,8474564,Steven Stamkos
79,23,23,46,0.1271,,20082009,8474564,Steven Stamkos
24,0,2,2,0.0,5.73,20242025,8477971,Andreas Englund
82,1,9,10,0.02439,5.79,20232024,8477971,Andreas Englund
11,0,1,1,0.0,7.4,20222023,8477971,Andreas Englund
6,0,1,1,0.0,5.73,20242025,8475857,Kevin Gravel
68,5,7,12,0.067568,5.73,20242025,8479980,Nicolas Hague
73,2,10,12,0.019048,5.79,20232024,8479980,Nicolas Hague
81,3,14,17,0.029126,7.4,20222023,8479980,Nicolas Hague
52,4,10,14,0.034,0.2,20212022,8479980,Nicolas Hague
52,5,12,17,0.064,0.41,20202021,8479980,Nicolas Hague
38,1,10,11,0.019,,20192020,8479980,Nicolas Hague
53,9,29,38,0.06,5.73,20242025,8474600,Roman Josi
82,23,62,85,0.085821,5.79,20232024,8474600,Roman Josi
67,18,41,59,0.066914,7.4,20222023,8474600,Roman Josi
80,23,73,96,0.082,0.2,20212022,8474600,Roman Josi
48,8,25,33,0.057,0.41,20202021,8474600,Roman Josi
69,16,49,65,0.062,,20192020,8474600,Roman Josi
82,15,41,56,0.0547,,20182019,8474600,Roman Josi
75,14,39,53,0.0553,,20172018,8474600,Roman Josi
72,12,37,49,0.0553,,20162017,8474600,Roman Josi
81,14,47,61,0.0707,,20152016,8474600,Roman Josi
81,15,40,55,0.0746,,20142015,8474600,Roman Josi
72,13,27,40,0.0774,,20132014,8474600,Roman Josi
48,5,13,18,0.0521,,20122013,8474600,Roman Josi
52,5,11,16,0.0781,,20112012,8474600,Roman Josi
15,3,1,4,0.166667,5.73,20242025,8477851,Jordan Oesterle
22,0,2,2,0.0,5.79,20232024,8477851,Jordan Oesterle
52,2,9,11,0.037037,7.4,20222023,8477851,Jordan Oesterle
45,2,6,8,0.032,0.2,20212022,8477851,Jordan Oesterle
43,1,10,11,0.026,0.41,20202021,8477851,Jordan Oesterle
58,3,10,13,0.043,,20192020,8477851,Jordan Oesterle
71,6,14,20,0.0779,,20182019,8477851,Jordan Oesterle
55,5,10,15,0.0505,,20172018,8477851,Jordan Oesterle
2,0,0,0,0.0,,20162017,8477851,Jordan Oesterle
17,0,5,5,0.0,,20152016,8477851,Jordan Oesterle
6,0,1,1,0.0,,20142015,8477851,Jordan Oesterle
82,10,23,33,0.064103,5.73,20242025,8476869,Brady Skjei
80,13,34,47,0.07027,5.79,20232024,8476869,Brady Skjei
81,18,20,38,0.095745,7.4,20222023,8476869,Brady Skjei
82,9,30,39,0.049,0.2,20212022,8476869,Brady Skjei
52,3,7,10,0.029,0.41,20202021,8476869,Brady Skjei
7,0,1,1,0.0,,20192020,8476869,Brady Skjei
78,8,17,25,0.0635,,20182019,8476869,Brady Skjei
82,4,21,25,0.0261,,20172018,8476869,Brady Skjei
80,5,34,39,0.0394,,20162017,8476869,Brady Skjei
7,0,0,0,0.0,,20152016,8476869,Brady Skjei
30,6,14,20,0.076923,5.73,20242025,8478445,Mathew Barzal
80,23,57,80,0.095833,5.79,20232024,8478445,Mathew Barzal
58,14,37,51,0.100719,7.4,20222023,8478445,Mathew Barzal
73,15,44,59,0.093,0.2,20212022,8478445,Mathew Barzal
55,17,28,45,0.127,0.41,20202021,8478445,Mathew Barzal
68,19,41,60,0.111,,20192020,8478445,Mathew Barzal
82,18,44,62,0.1006,,20182019,8478445,Mathew Barzal
82,22,63,85,0.1294,,20172018,8478445,Mathew Barzal
2,0,0,0,0.0,,20162017,8478445,Mathew Barzal
82,7,10,17,0.072165,5.73,20242025,8475231,Casey Cizikas
70,10,13,23,0.121951,5.79,20232024,8475231,Casey Cizikas
81,6,15,21,0.054054,7.4,20222023,8475231,Casey Cizikas
74,10,6,16,0.11,0.2,20212022,8475231,Casey Cizikas
56,7,7,14,0.097,0.41,20202021,8475231,Casey Cizikas
48,10,4,14,0.149,,20192020,8475231,Casey Cizikas
73,20,13,33,0.1802,,20182019,8475231,Casey Cizikas
64,7,10,17,0.0946,,20172018,8475231,Casey Cizikas
59,8,17,25,0.0976,,20162017,8475231,Casey Cizikas
80,8,21,29,0.0952,,20152016,8475231,Casey Cizikas
70,9,9,18,0.1,,20142015,8475231,Casey Cizikas
80,6,10,16,0.0759,,20132014,8475231,Casey Cizikas
45,6,9,15,0.1333,,20122013,8475231,Casey Cizikas
15,0,4,4,0.0,,20112012,8475231,Casey Cizikas
43,11,26,37,0.196429,5.73,20242025,8477494,Jonathan Drouin
79,19,37,56,0.149606,5.79,20232024,8477494,Jonathan Drouin
58,2,27,29,0.028986,7.4,20222023,8477494,Jonathan Drouin
34,6,14,20,0.097,0.2,20212022,8477494,Jonathan Drouin
44,2,21,23,0.026,0.41,20202021,8477494,Jonathan Drouin
27,7,8,15,0.137,,20192020,8477494,Jonathan Drouin
81,18,35,53,0.0947,,20182019,8477494,Jonathan Drouin
77,13,33,46,0.0793,,20172018,8477494,Jonathan Drouin
73,21,32,53,0.1148,,20162017,8477494,Jonathan Drouin
21,4,6,10,0.16,,20152016,8477494,Jonathan Drouin
70,4,28,32,0.0526,,20142015,8477494,Jonathan Drouin
44,7,4,11,0.116667,5.73,20242025,8477407,Anthony Duclair
17,8,7,15,0.258065,5.79,20232024,8477407,Anthony Duclair
20,2,7,9,0.046512,7.4,20222023,8477407,Anthony Duclair
74,31,27,58,0.186,0.2,20212022,8477407,Anthony Duclair
43,10,22,32,0.096,0.41,20202021,8477407,Anthony Duclair
66,23,17,40,0.125,,20192020,8477407,Anthony Duclair
21,8,6,14,0.2,,20182019,8477407,Anthony Duclair
23,2,6,8,0.069,,20172018,8477407,Anthony Duclair
58,5,10,15,0.0658,,20162017,8477407,Anthony Duclair
81,20,24,44,0.1905,,20152016,8477407,Anthony Duclair
18,1,6,7,0.0556,,20142015,8477407,Anthony Duclair
62,8,7,15,0.086022,5.73,20242025,8478115,Pierre Engvall
74,10,18,28,0.078125,5.79,20232024,8478115,Pierre Engvall
18,5,4,9,0.16129,7.4,20222023,8478115,Pierre Engvall
78,15,20,35,0.097,0.2,20212022,8478115,Pierre Engvall
42,7,5,12,0.115,0.41,20202021,8478115,Pierre Engvall
48,8,7,15,0.111,,20192020,8478115,Pierre Engvall
1,0,0,0,0.0,5.73,20242025,8479328,Julien Gauthier
27,5,4,9,0.15625,5.79,20232024,8479328,Julien Gauthier
17,3,2,5,0.176471,7.4,20222023,8479328,Julien Gauthier
49,3,4,7,0.043,0.2,20212022,8479328,Julien Gauthier
30,2,6,8,0.053,0.41,20202021,8479328,Julien Gauthier
12,0,2,2,0.0,,20192020,8479328,Julien Gauthier
81,28,29,57,0.115226,5.73,20242025,8477500,Bo Horvat
81,33,35,68,0.133065,5.79,20232024,8477500,Bo Horvat
30,7,9,16,0.081395,7.4,20222023,8477500,Bo Horvat
70,31,21,52,0.16,0.2,20212022,8477500,Bo Horvat
56,19,20,39,0.145,0.41,20202021,8477500,Bo Horvat
69,22,31,53,0.124,,20192020,8477500,Bo Horvat
82,27,34,61,0.1189,,20182019,8477500,Bo Horvat
64,22,22,44,0.1392,,20172018,8477500,Bo Horvat
81,20,32,52,0.1266,,20162017,8477500,Bo Horvat
82,16,24,40,0.1032,,20152016,8477500,Bo Horvat
68,13,12,25,0.1398,,20142015,8477500,Bo Horvat
82,29,25,54,0.124464,5.73,20242025,8475314,Anders Lee
81,20,17,37,0.108108,5.79,20232024,8475314,Anders Lee
82,28,22,50,0.130841,7.4,20222023,8475314,Anders Lee
76,28,18,46,0.176,0.2,20212022,8475314,Anders Lee
27,12,7,19,0.15,0.41,20202021,8475314,Anders Lee
68,20,23,43,0.103,,20192020,8475314,Anders Lee
82,28,23,51,0.1373,,20182019,8475314,Anders Lee
82,40,22,62,0.1923,,20172018,8475314,Anders Lee
81,34,18,52,0.178,,20162017,8475314,Anders Lee
80,15,21,36,0.082,,20152016,8475314,Anders Lee
76,25,16,41,0.1269,,20142015,8475314,Anders Lee
22,9,5,14,0.1324,,20132014,8475314,Anders Lee
2,1,1,2,0.5,,20122013,8475314,Anders Lee
79,14,28,42,0.116667,5.73,20242025,8476419,Jean-Gabriel Pageau
82,11,22,33,0.108911,5.79,20232024,8476419,Jean-Gabriel Pageau
70,13,27,40,0.105691,7.4,20222023,8476419,Jean-Gabriel Pageau
77,18,21,39,0.143,0.2,20212022,8476419,Jean-Gabriel Pageau
54,14,14,28,0.173,0.41,20202021,8476419,Jean-Gabriel Pageau
7,2,0,2,0.125,,20192020,8476419,Jean-Gabriel Pageau
39,4,8,12,0.0482,,20182019,8476419,Jean-Gabriel Pageau
78,14,15,29,0.0952,,20172018,8476419,Jean-Gabriel Pageau
82,12,21,33,0.071,,20162017,8476419,Jean-Gabriel Pageau
82,19,24,43,0.1429,,20152016,8476419,Jean-Gabriel Pageau
50,10,9,19,0.1031,,20142015,8476419,Jean-Gabriel Pageau
28,2,0,2,0.0645,,20132014,8476419,Jean-Gabriel Pageau
9,2,2,4,0.1429,,20122013,8476419,Jean-Gabriel Pageau
82,24,24,48,0.142012,5.73,20242025,8475151,Kyle Palmieri
82,30,24,54,0.137615,5.79,20232024,8475151,Kyle Palmieri
55,16,17,33,0.131148,7.4,20222023,8475151,Kyle Palmieri
69,15,18,33,0.096,0.2,20212022,8475151,Kyle Palmieri
17,2,2,4,0.065,0.41,20202021,8475151,Kyle Palmieri
65,25,20,45,0.161,,20192020,8475151,Kyle Palmieri
74,27,23,50,0.1205,,20182019,8475151,Kyle Palmieri
62,24,20,44,0.1326,,20172018,8475151,Kyle Palmieri
80,26,27,53,0.1354,,20162017,8475151,Kyle Palmieri
82,30,27,57,0.1351,,20152016,8475151,Kyle Palmieri
57,14,15,29,0.125,,20142015,8475151,Kyle Palmieri
71,14,17,31,0.0952,,20132014,8475151,Kyle Palmieri
42,10,11,21,0.1087,,20122013,8475151,Kyle Palmieri
18,4,3,7,0.1176,,20112012,8475151,Kyle Palmieri
10,1,0,1,0.1,,20102011,8475151,Kyle Palmieri
17,2,6,8,0.105263,5.73,20242025,8480871,Adam Boqvist
35,1,9,10,0.022222,5.79,20232024,8480871,Adam Boqvist
46,5,19,24,0.073529,7.4,20222023,8480871,Adam Boqvist
52,11,11,22,0.172,0.2,20212022,8480871,Adam Boqvist
35,2,14,16,0.051,0.41,20202021,8480871,Adam Boqvist
41,4,9,13,0.08,,20192020,8480871,Adam Boqvist
35,4,15,19,0.052632,5.73,20242025,8477950,Tony DeAngelo
31,3,8,11,0.068182,5.79,20232024,8477950,Tony DeAngelo
70,11,31,42,0.063218,7.4,20222023,8477950,Tony DeAngelo
64,10,41,51,0.066,0.2,20212022,8477950,Tony DeAngelo
6,0,1,1,0.0,0.41,20202021,8477950,Tony DeAngelo
68,15,38,53,0.101,,20192020,8477950,Tony DeAngelo
61,4,26,30,0.036,,20182019,8477950,Tony DeAngelo
32,0,8,8,0.0,,20172018,8477950,Tony DeAngelo
39,5,9,14,0.0833,,20162017,8477950,Tony DeAngelo
66,3,6,9,0.058824,5.73,20242025,8476429,Scott Mayfield
41,0,5,5,0.0,5.79,20232024,8476429,Scott Mayfield
82,6,18,24,0.05042,7.4,20222023,8476429,Scott Mayfield
61,3,15,18,0.038,0.2,20212022,8476429,Scott Mayfield
56,2,13,15,0.025,0.41,20202021,8476429,Scott Mayfield
67,5,8,13,0.051,,20192020,8476429,Scott Mayfield
79,4,15,19,0.0385,,20182019,8476429,Scott Mayfield
47,2,10,12,0.0345,,20172018,8476429,Scott Mayfield
25,2,7,9,0.0513,,20162017,8476429,Scott Mayfield
6,1,0,1,0.25,,20152016,8476429,Scott Mayfield
60,0,21,21,0.0,5.73,20242025,8476917,Adam Pelech
58,1,15,16,0.014085,5.79,20232024,8476917,Adam Pelech
61,6,15,21,0.061856,7.4,20222023,8476917,Adam Pelech
78,3,25,28,0.029,0.2,20212022,8476917,Adam Pelech
56,4,10,14,0.049,0.41,20202021,8476917,Adam Pelech
38,1,8,9,0.02,,20192020,8476917,Adam Pelech
78,5,16,21,0.0455,,20182019,8476917,Adam Pelech
78,3,16,19,0.0283,,20172018,8476917,Adam Pelech
44,3,7,10,0.075,,20162017,8476917,Adam Pelech
9,0,2,2,0.0,,20152016,8476917,Adam Pelech
74,5,18,23,0.051546,5.73,20242025,8477506,Ryan Pulock
58,5,14,19,0.055556,5.79,20232024,8477506,Ryan Pulock
82,5,21,26,0.039683,7.4,20222023,8477506,Ryan Pulock
56,5,16,21,0.041,0.2,20212022,8477506,Ryan Pulock
56,2,15,17,0.017,0.41,20202021,8477506,Ryan Pulock
68,10,25,35,0.061,,20192020,8477506,Ryan Pulock
82,9,28,37,0.05,,20182019,8477506,Ryan Pulock
68,10,22,32,0.0543,,20172018,8477506,Ryan Pulock
1,0,0,0,0.0,,20162017,8477506,Ryan Pulock
15,2,2,4,0.1333,,20152016,8477506,Ryan Pulock
64,4,16,20,0.04,5.73,20242025,8481014,Alexander Romanov
81,7,15,22,0.059829,5.79,20232024,8481014,Alexander Romanov
76,2,20,22,0.02,7.4,20222023,8481014,Alexander Romanov
79,3,10,13,0.028,0.2,20212022,8481014,Alexander Romanov
54,1,5,6,0.014,0.41,20202021,8481014,Alexander Romanov
51,12,7,19,0.164384,5.73,20242025,8477380,Jonny Brodzinski
57,6,13,19,0.067416,5.79,20232024,8477380,Jonny Brodzinski
17,1,1,2,0.037037,7.4,20222023,8477380,Jonny Brodzinski
22,1,1,2,0.029,0.2,20212022,8477380,Jonny Brodzinski
5,1,0,1,0.143,0.41,20202021,8477380,Jonny Brodzinski
3,0,1,1,0.0,,20192020,8477380,Jonny Brodzinski
13,2,1,3,0.1176,,20182019,8477380,Jonny Brodzinski
35,4,2,6,0.0755,,20172018,8477380,Jonny Brodzinski
6,0,2,2,0.0,,20162017,8477380,Jonny Brodzinski
80,6,14,20,0.071429,5.73,20242025,8475842,Sam Carrick
16,2,3,5,0.133333,5.79,20232024,8475842,Sam Carrick
52,3,4,7,0.06,7.4,20222023,8475842,Sam Carrick
64,11,8,19,0.138,0.2,20212022,8475842,Sam Carrick
13,2,4,6,0.087,0.41,20202021,8475842,Sam Carrick
9,1,1,2,0.063,,20192020,8475842,Sam Carrick
6,0,1,1,0.0,,20182019,8475842,Sam Carrick
52,2,5,7,0.058824,5.73,20242025,8475413,Justin Dowling
2,1,0,1,0.333333,5.79,20232024,8475413,Justin Dowling
82,17,28,45,0.111111,5.73,20242025,8482109,Alexis Lafrenière
82,28,29,57,0.129032,5.79,20232024,8482109,Alexis Lafrenière
81,16,23,39,0.118519,7.4,20222023,8482109,Alexis Lafrenière
79,19,12,31,0.173,0.2,20212022,8482109,Alexis Lafrenière
56,12,9,21,0.179,0.41,20202021,8482109,Alexis Lafrenière
32,13,22,35,0.236364,5.73,20242025,8476468,J.T. Miller
81,37,66,103,0.190722,5.79,20232024,8476468,J.T. Miller
81,32,50,82,0.143498,7.4,20222023,8476468,J.T. Miller
80,32,67,99,0.155,0.2,20212022,8476468,J.T. Miller
53,15,31,46,0.142,0.41,20202021,8476468,J.T. Miller
69,27,45,72,0.164,,20192020,8476468,J.T. Miller
75,13,34,47,0.1204,,20182019,8476468,J.T. Miller
19,10,8,18,0.2222,,20172018,8476468,J.T. Miller
82,22,34,56,0.1667,,20162017,8476468,J.T. Miller
82,22,21,43,0.163,,20152016,8476468,J.T. Miller
58,10,13,23,0.1087,,20142015,8476468,J.T. Miller
30,3,3,6,0.0652,,20132014,8476468,J.T. Miller
26,2,2,4,0.0465,,20122013,8476468,J.T. Miller
80,37,52,89,0.156118,5.73,20242025,8478550,Artemi Panarin
82,49,71,120,0.161716,5.79,20232024,8478550,Artemi Panarin
82,29,63,92,0.142157,7.4,20222023,8478550,Artemi Panarin
75,22,74,96,0.124,0.2,20212022,8478550,Artemi Panarin
42,17,41,58,0.16,0.41,20202021,8478550,Artemi Panarin
69,32,63,95,0.153,,20192020,8478550,Artemi Panarin
79,28,59,87,0.1466,,20182019,8478550,Artemi Panarin
81,27,55,82,0.1184,,20172018,8478550,Artemi Panarin
82,31,43,74,0.1469,,20162017,8478550,Artemi Panarin
80,30,47,77,0.1604,,20152016,8478550,Artemi Panarin
82,26,33,59,0.128713,5.73,20242025,8476389,Vincent Trocheck
82,25,52,77,0.116279,5.79,20232024,8476389,Vincent Trocheck
82,22,42,64,0.097778,7.4,20222023,8476389,Vincent Trocheck
81,21,30,51,0.125,0.2,20212022,8476389,Vincent Trocheck
47,17,26,43,0.138,0.41,20202021,8476389,Vincent Trocheck
7,1,1,2,0.083,,20192020,8476389,Vincent Trocheck
55,10,24,34,0.0633,,20182019,8476389,Vincent Trocheck
82,31,44,75,0.108,,20172018,8476389,Vincent Trocheck
82,23,31,54,0.1,,20162017,8476389,Vincent Trocheck
76,25,28,53,0.1437,,20152016,8476389,Vincent Trocheck
50,7,15,22,0.0787,,20142015,8476389,Vincent Trocheck
20,5,3,8,0.1316,,20132014,8476389,Vincent Trocheck
82,20,42,62,0.10929,5.73,20242025,8476459,Mika Zibanejad
81,26,46,72,0.117647,5.79,20232024,8476459,Mika Zibanejad
82,39,52,91,0.155378,7.4,20222023,8476459,Mika Zibanejad
81,29,52,81,0.132,0.2,20212022,8476459,Mika Zibanejad
56,24,26,50,0.14,0.41,20202021,8476459,Mika Zibanejad
57,41,34,75,0.197,,20192020,8476459,Mika Zibanejad
82,30,44,74,0.1271,,20182019,8476459,Mika Zibanejad
72,27,20,47,0.1274,,20172018,8476459,Mika Zibanejad
56,14,23,37,0.1176,,20162017,8476459,Mika Zibanejad
81,21,30,51,0.1141,,20152016,8476459,Mika Zibanejad
80,20,26,46,0.1333,,20142015,8476459,Mika Zibanejad
69,16,17,33,0.1046,,20132014,8476459,Mika Zibanejad
42,7,13,20,0.0778,,20122013,8476459,Mika Zibanejad
9,0,1,1,0.0,,20112012,8476459,Mika Zibanejad
51,4,9,13,0.070175,5.73,20242025,8478840,Will Borgen
82,3,22,25,0.030928,5.79,20232024,8478840,Will Borgen
82,3,17,20,0.039474,7.4,20222023,8478840,Will Borgen
36,2,6,8,0.041,0.2,20212022,8478840,Will Borgen
10,0,0,0,0.0,0.41,20202021,8478840,Will Borgen
74,10,51,61,0.074074,5.73,20242025,8479323,Adam Fox
72,17,56,73,0.124088,5.79,20232024,8479323,Adam Fox
82,12,60,72,0.075472,7.4,20222023,8479323,Adam Fox
78,11,63,74,0.07,0.2,20212022,8479323,Adam Fox
55,5,42,47,0.049,0.41,20202021,8479323,Adam Fox
70,8,34,42,0.064,,20192020,8479323,Adam Fox
82,5,25,30,0.044643,5.73,20242025,8478882,Vladislav Gavrikov
77,6,17,23,0.052632,5.79,20232024,8478882,Vladislav Gavrikov
20,3,6,9,0.107143,7.4,20222023,8478882,Vladislav Gavrikov
80,5,28,33,0.046,0.2,20212022,8478882,Vladislav Gavrikov
55,2,10,12,0.042,0.41,20202021,8478882,Vladislav Gavrikov
69,5,13,18,0.062,,20192020,8478882,Vladislav Gavrikov
2,0,0,0,0.0,5.73,20242025,8482067,Connor Mackey
1,0,0,0,0.0,5.79,20232024,8482067,Connor Mackey
20,1,3,4,0.043478,7.4,20222023,8482067,Connor Mackey
3,0,1,1,0.0,0.2,20212022,8482067,Connor Mackey
6,1,2,3,0.25,0.41,20202021,8482067,Connor Mackey
16,1,2,3,0.052632,5.73,20242025,8477369,Carson Soucy
40,2,4,6,0.068966,5.79,20232024,8477369,Carson Soucy
78,3,13,16,0.034483,7.4,20222023,8477369,Carson Soucy
64,10,11,21,0.103,0.2,20212022,8477369,Carson Soucy
50,1,16,17,0.021,0.41,20202021,8477369,Carson Soucy
55,7,7,14,0.115,,20192020,8477369,Carson Soucy
46,2,13,15,0.051282,5.73,20242025,8480001,Urho Vaakanainen
68,1,13,14,0.014925,5.79,20232024,8480001,Urho Vaakanainen
23,0,2,2,0.0,7.4,20222023,8480001,Urho Vaakanainen
14,0,2,2,0.0,0.2,20212022,8480001,Urho Vaakanainen
9,0,2,2,0.0,0.41,20202021,8480001,Urho Vaakanainen
5,0,0,0,0.0,,20192020,8480001,Urho Vaakanainen
2,0,0,0,0.0,,20182019,8480001,Urho Vaakanainen
72,11,16,27,0.129412,5.73,20242025,8478020,Michael Amadio
73,14,13,27,0.119658,5.79,20232024,8478020,Michael Amadio
67,16,11,27,0.161616,7.4,20222023,8478020,Michael Amadio
53,11,7,18,0.177,0.2,20212022,8478020,Michael Amadio
5,0,1,1,0.0,0.41,20202021,8478020,Michael Amadio
68,6,10,16,0.061,,20192020,8478020,Michael Amadio
43,6,7,13,0.1622,,20182019,8478020,Michael Amadio
37,4,4,8,0.1429,,20172018,8478020,Michael Amadio
82,26,42,68,0.135417,5.73,20242025,8480208,Drake Batherson
82,28,38,66,0.142857,5.79,20232024,8480208,Drake Batherson
82,22,40,62,0.088353,7.4,20222023,8480208,Drake Batherson
46,17,27,44,0.155,0.2,20212022,8480208,Drake Batherson
56,17,17,34,0.153,0.41,20202021,8480208,Drake Batherson
23,3,7,10,0.094,,20192020,8480208,Drake Batherson
20,3,6,9,0.1667,,20182019,8480208,Drake Batherson
50,6,9,15,0.088235,5.73,20242025,8476393,Nick Cousins
69,7,8,15,0.063063,5.79,20232024,8476393,Nick Cousins
79,9,18,27,0.088235,7.4,20222023,8476393,Nick Cousins
68,9,13,22,0.087,0.2,20212022,8476393,Nick Cousins
52,5,13,18,0.083,0.41,20202021,8476393,Nick Cousins
7,1,2,3,0.1,,20192020,8476393,Nick Cousins
81,7,20,27,0.0486,,20182019,8476393,Nick Cousins
71,12,7,19,0.1008,,20172018,8476393,Nick Cousins
60,6,10,16,0.0606,,20162017,8476393,Nick Cousins
36,6,5,11,0.1463,,20152016,8476393,Nick Cousins
11,0,0,0,0.0,,20142015,8476393,Nick Cousins
21,5,11,16,0.102041,5.73,20242025,8481528,Dylan Cozens
79,18,29,47,0.09,5.79,20232024,8481528,Dylan Cozens
81,31,37,68,0.146919,7.4,20222023,8481528,Dylan Cozens
79,13,25,38,0.081,0.2,20212022,8481528,Dylan Cozens
41,4,9,13,0.065,0.41,20202021,8481528,Dylan Cozens
63,6,9,15,0.077922,5.73,20242025,8474189,Lars Eller
82,15,16,31,0.097403,5.79,20232024,8474189,Lars Eller
24,3,4,7,0.076923,7.4,20222023,8474189,Lars Eller
72,13,18,31,0.112,0.2,20212022,8474189,Lars Eller
44,8,15,23,0.116,0.41,20202021,8474189,Lars Eller
69,16,23,39,0.106,,20192020,8474189,Lars Eller
81,13,23,36,0.0798,,20182019,8474189,Lars Eller
81,18,20,38,0.1118,,20172018,8474189,Lars Eller
81,12,13,25,0.1043,,20162017,8474189,Lars Eller
79,13,13,26,0.0872,,20152016,8474189,Lars Eller
77,15,12,27,0.1,,20142015,8474189,Lars Eller
77,12,14,26,0.0876,,20132014,8474189,Lars Eller
46,8,22,30,0.0952,,20122013,8474189,Lars Eller
79,16,12,28,0.124,,20112012,8474189,Lars Eller
77,7,10,17,0.0886,,20102011,8474189,Lars Eller
7,2,0,2,0.25,,20092010,8474189,Lars Eller
81,15,35,50,0.108696,5.73,20242025,8473512,Claude Giroux
82,21,43,64,0.114754,5.79,20232024,8473512,Claude Giroux
82,35,44,79,0.163551,7.4,20222023,8473512,Claude Giroux
18,3,20,23,0.059,0.2,20212022,8473512,Claude Giroux
54,16,27,43,0.133,0.41,20202021,8473512,Claude Giroux
69,21,32,53,0.107,,20192020,8473512,Claude Giroux
82,22,63,85,0.0961,,20182019,8473512,Claude Giroux
82,34,68,102,0.1762,,20172018,8473512,Claude Giroux
82,14,44,58,0.0704,,20162017,8473512,Claude Giroux
78,22,45,67,0.0913,,20152016,8473512,Claude Giroux
81,25,48,73,0.0896,,20142015,8473512,Claude Giroux
82,28,58,86,0.1256,,20132014,8473512,Claude Giroux
48,13,35,48,0.0949,,20122013,8473512,Claude Giroux
77,28,65,93,0.1157,,20112012,8473512,Claude Giroux
82,25,51,76,0.1479,,20102011,8473512,Claude Giroux
82,16,31,47,0.1103,,20092010,8473512,Claude Giroux
42,9,18,27,0.1343,,20082009,8473512,Claude Giroux
2,0,0,0,0.0,,20072008,8473512,Claude Giroux
2,0,0,0,0.0,5.73,20242025,8480890,Jan Jenik
5,0,1,1,0.0,5.79,20232024,8480890,Jan Jenik
2,0,0,0,0.0,7.4,20222023,8480890,Jan Jenik
13,2,1,3,0.091,0.2,20212022,8480890,Jan Jenik
2,2,0,2,0.667,0.41,20202021,8480890,Jan Jenik
14,3,1,4,0.142857,5.73,20242025,8481560,Arthur Kaliyev
51,7,8,15,0.069307,5.79,20232024,8481560,Arthur Kaliyev
56,13,15,28,0.106557,7.4,20222023,8481560,Arthur Kaliyev
80,14,13,27,0.072,0.2,20212022,8481560,Arthur Kaliyev
1,1,0,1,1.0,0.41,20202021,8481560,Arthur Kaliyev
21,2,1,3,0.076923,5.73,20242025,8479772,Zack MacEwen
30,2,1,3,0.117647,5.79,20232024,8479772,Zack MacEwen
10,0,1,1,0.0,7.4,20222023,8479772,Zack MacEwen
75,3,6,9,0.037,0.2,20212022,8479772,Zack MacEwen
34,1,1,2,0.032,0.41,20202021,8479772,Zack MacEwen
17,5,1,6,0.294,,20192020,8479772,Zack MacEwen
4,0,1,1,0.0,,20182019,8479772,Zack MacEwen
43,9,7,16,0.126761,5.73,20242025,8474102,David Perron
76,17,30,47,0.112583,5.79,20232024,8474102,David Perron
82,24,32,56,0.123077,7.4,20222023,8474102,David Perron
67,27,30,57,0.153,0.2,20212022,8474102,David Perron
56,19,39,58,0.126,0.41,20202021,8474102,David Perron
71,25,35,60,0.151,,20192020,8474102,David Perron
57,23,23,46,0.2054,,20182019,8474102,David Perron
70,16,50,66,0.128,,20172018,8474102,David Perron
82,18,28,46,0.1192,,20162017,8474102,David Perron
28,8,12,20,0.1569,,20152016,8474102,David Perron
43,12,10,22,0.0984,,20142015,8474102,David Perron
78,28,29,57,0.1273,,20132014,8474102,David Perron
48,10,15,25,0.119,,20122013,8474102,David Perron
57,21,21,42,0.1842,,20112012,8474102,David Perron
10,5,2,7,0.1724,,20102011,8474102,David Perron
82,20,27,47,0.1205,,20092010,8474102,David Perron
81,15,35,50,0.0932,,20082009,8474102,David Perron
62,13,14,27,0.1912,,20072008,8474102,David Perron
70,21,16,37,0.165354,5.73,20242025,8481596,Shane Pinto
41,9,18,27,0.081818,5.79,20232024,8481596,Shane Pinto
82,20,15,35,0.126582,7.4,20222023,8481596,Shane Pinto
5,0,1,1,0.0,0.2,20212022,8481596,Shane Pinto
12,1,6,7,0.091,0.41,20202021,8481596,Shane Pinto
82,24,55,79,0.148148,5.73,20242025,8482116,Tim Stützle
75,18,52,70,0.09375,5.79,20232024,8482116,Tim Stützle
78,39,51,90,0.171053,7.4,20222023,8482116,Tim Stützle
79,22,36,58,0.125,0.2,20212022,8482116,Tim Stützle
53,12,17,29,0.108,0.41,20202021,8482116,Tim Stützle
72,29,26,55,0.097973,5.73,20242025,8480801,Brady Tkachuk
81,37,37,74,0.103641,5.79,20232024,8480801,Brady Tkachuk
82,35,48,83,0.100865,7.4,20222023,8480801,Brady Tkachuk
79,30,37,67,0.104,0.2,20212022,8480801,Brady Tkachuk
56,17,19,36,0.077,0.41,20202021,8480801,Brady Tkachuk
71,21,23,44,0.081,,20192020,8480801,Brady Tkachuk
71,22,23,45,0.1028,,20182019,8480801,Brady Tkachuk
80,9,36,45,0.050279,5.73,20242025,8478469,Thomas Chabot
51,9,21,30,0.076271,5.79,20232024,8478469,Thomas Chabot
68,11,30,41,0.066667,7.4,20222023,8478469,Thomas Chabot
59,7,31,38,0.04,0.2,20212022,8478469,Thomas Chabot
49,6,25,31,0.05,0.41,20202021,8478469,Thomas Chabot
71,6,33,39,0.032,,20192020,8478469,Thomas Chabot
70,14,41,55,0.0757,,20182019,8478469,Thomas Chabot
63,9,16,25,0.0957,,20172018,8478469,Thomas Chabot
1,0,0,0,0.0,,20162017,8478469,Thomas Chabot
71,3,18,21,0.038961,5.73,20242025,8475324,Nick Jensen
78,1,13,14,0.014085,5.79,20232024,8475324,Nick Jensen
77,5,24,29,0.045872,7.4,20222023,8475324,Nick Jensen
76,5,16,21,0.057,0.2,20212022,8475324,Nick Jensen
53,2,12,14,0.033,0.41,20202021,8475324,Nick Jensen
68,0,8,8,0.0,,20192020,8475324,Nick Jensen
20,0,5,5,0.0,,20182019,8475324,Nick Jensen
81,0,15,15,0.0,,20172018,8475324,Nick Jensen
49,4,9,13,0.0678,,20162017,8475324,Nick Jensen
56,2,11,13,0.035088,5.73,20242025,8482245,Artem Zub
69,5,20,25,0.058824,5.79,20232024,8482245,Artem Zub
53,3,7,10,0.073171,7.4,20222023,8482245,Artem Zub
81,6,16,22,0.065,0.2,20212022,8482245,Artem Zub
47,3,11,14,0.077,0.41,20202021,8482245,Artem Zub
79,15,30,45,0.096774,5.73,20242025,8476461,Sean Couturier
74,11,27,38,0.057292,5.79,20232024,8476461,Sean Couturier
31,2,1,3,0.08,5.73,20242025,8475235,Nicolas Deslauriers
60,1,3,4,0.020408,5.79,20232024,8475235,Nicolas Deslauriers
80,6,6,12,0.085714,7.4,20222023,8475235,Nicolas Deslauriers
20,3,0,3,0.167,0.2,20212022,8475235,Nicolas Deslauriers
49,5,5,10,0.077,0.41,20202021,8475235,Nicolas Deslauriers
59,7,6,13,0.109,,20192020,8475235,Nicolas Deslauriers
48,2,3,5,0.0417,,20182019,8475235,Nicolas Deslauriers
58,10,4,14,0.1299,,20172018,8475235,Nicolas Deslauriers
42,0,2,2,0.0,,20162017,8475235,Nicolas Deslauriers
70,6,6,12,0.0833,,20152016,8475235,Nicolas Deslauriers
82,5,10,15,0.0658,,20142015,8475235,Nicolas Deslauriers
17,1,0,1,0.0333,,20132014,8475235,Nicolas Deslauriers
82,12,21,33,0.115385,5.73,20242025,8477989,Christian Dvorak
30,5,4,9,0.142857,5.79,20232024,8477989,Christian Dvorak
64,10,18,28,0.113636,7.4,20222023,8477989,Christian Dvorak
56,11,22,33,0.126,0.2,20212022,8477989,Christian Dvorak
56,17,14,31,0.179,0.41,20202021,8477989,Christian Dvorak
70,18,20,38,0.134,,20192020,8477989,Christian Dvorak
20,2,5,7,0.08,,20182019,8477989,Christian Dvorak
78,15,22,37,0.0993,,20172018,8477989,Christian Dvorak
78,15,18,33,0.1705,,20162017,8477989,Christian Dvorak
67,10,11,21,0.125,5.73,20242025,8477903,Garnet Hathaway
82,7,10,17,0.067961,5.79,20232024,8477903,Garnet Hathaway
25,4,2,6,0.222222,7.4,20222023,8477903,Garnet Hathaway
76,14,12,26,0.113,0.2,20212022,8477903,Garnet Hathaway
56,6,12,18,0.097,0.41,20202021,8477903,Garnet Hathaway
66,9,7,16,0.113,,20192020,8477903,Garnet Hathaway
76,11,8,19,0.1429,,20182019,8477903,Garnet Hathaway
59,4,9,13,0.0588,,20172018,8477903,Garnet Hathaway
26,1,4,5,0.0455,,20162017,8477903,Garnet Hathaway
14,0,3,3,0.0,,20152016,8477903,Garnet Hathaway
82,24,52,76,0.12766,5.73,20242025,8478439,Travis Konecny
76,33,35,68,0.135246,5.79,20232024,8478439,Travis Konecny
60,31,30,61,0.162304,7.4,20222023,8478439,Travis Konecny
79,16,36,52,0.073,0.2,20212022,8478439,Travis Konecny
50,11,23,34,0.11,0.41,20202021,8478439,Travis Konecny
66,24,37,61,0.17,,20192020,8478439,Travis Konecny
82,24,25,49,0.1319,,20182019,8478439,Travis Konecny
81,24,23,47,0.1356,,20172018,8478439,Travis Konecny
70,11,17,28,0.0827,,20162017,8478439,Travis Konecny
15,2,4,6,0.105263,5.73,20242025,8478409,Anthony Richard
9,1,2,3,0.166667,5.79,20232024,8478409,Anthony Richard
13,3,2,5,0.230769,7.4,20222023,8478409,Anthony Richard
77,20,23,43,0.106383,5.73,20242025,8480015,Owen Tippett
78,28,25,53,0.096886,5.79,20232024,8480015,Owen Tippett
77,27,22,49,0.116883,7.4,20222023,8480015,Owen Tippett
21,4,3,7,0.075,0.2,20212022,8480015,Owen Tippett
45,7,11,18,0.081,0.41,20202021,8480015,Owen Tippett
57,12,20,32,0.122449,5.73,20242025,8481533,Trevor Zegras
31,6,9,15,0.082192,5.79,20232024,8481533,Trevor Zegras
81,23,42,65,0.125,7.4,20222023,8481533,Trevor Zegras
75,23,38,61,0.127,0.2,20212022,8481533,Trevor Zegras
24,3,10,13,0.057,0.41,20202021,8481533,Trevor Zegras
70,7,13,20,0.111111,5.73,20242025,8482142,Jamie Drysdale
24,2,3,5,0.058824,5.79,20232024,8482142,Jamie Drysdale
8,0,0,0,0.0,7.4,20222023,8482142,Jamie Drysdale
81,4,28,32,0.029,0.2,20212022,8482142,Jamie Drysdale
24,3,5,8,0.107,0.41,20202021,8482142,Jamie Drysdale
4,0,1,1,0.0,5.73,20242025,8478502,Dennis Gilbert
34,1,6,7,0.043478,5.79,20232024,8478502,Dennis Gilbert
23,1,3,4,0.076923,7.4,20222023,8478502,Dennis Gilbert
35,0,0,0,0.0,5.73,20242025,8478454,Noah Juulsen
54,1,6,7,0.033333,5.79,20232024,8478454,Noah Juulsen
12,0,0,0,0.0,7.4,20222023,8478454,Noah Juulsen
8,0,2,2,0.0,0.2,20212022,8478454,Noah Juulsen
4,0,0,0,0.0,0.41,20202021,8478454,Noah Juulsen
63,4,15,19,0.04,5.73,20242025,8477499,Rasmus Ristolainen
31,1,3,4,0.021739,5.79,20232024,8477499,Rasmus Ristolainen
74,3,17,20,0.034884,7.4,20222023,8477499,Rasmus Ristolainen
66,2,14,16,0.021,0.2,20212022,8477499,Rasmus Ristolainen
49,4,14,18,0.055,0.41,20202021,8477499,Rasmus Ristolainen
69,6,27,33,0.047,,20192020,8477499,Rasmus Ristolainen
78,5,38,43,0.0275,,20182019,8477499,Rasmus Ristolainen
73,6,35,41,0.033,,20172018,8477499,Rasmus Ristolainen
79,6,39,45,0.0323,,20162017,8477499,Rasmus Ristolainen
82,9,32,41,0.0446,,20152016,8477499,Rasmus Ristolainen
78,8,12,20,0.0661,,20142015,8477499,Rasmus Ristolainen
34,2,2,4,0.0385,,20132014,8477499,Rasmus Ristolainen
82,8,22,30,0.057554,5.73,20242025,8477948,Travis Sanheim
81,10,34,44,0.068493,5.79,20232024,8477948,Travis Sanheim
81,7,16,23,0.063063,7.4,20222023,8477948,Travis Sanheim
80,7,24,31,0.057,0.2,20212022,8477948,Travis Sanheim
55,3,12,15,0.03,0.41,20202021,8477948,Travis Sanheim
69,8,17,25,0.073,,20192020,8477948,Travis Sanheim
82,9,26,35,0.0744,,20182019,8477948,Travis Sanheim
49,2,8,10,0.0278,,20172018,8477948,Travis Sanheim
77,3,17,20,0.036585,5.73,20242025,8476372,Nick Seeler
71,1,12,13,0.01,5.79,20232024,8476372,Nick Seeler
77,4,10,14,0.047619,7.4,20222023,8476372,Nick Seeler
43,1,2,3,0.031,0.2,20212022,8476372,Nick Seeler
66,4,13,17,0.061538,5.73,20242025,8481546,Cam York
82,10,20,30,0.074627,5.79,20232024,8481546,Cam York
54,2,18,20,0.047619,7.4,20222023,8481546,Cam York
30,3,7,10,0.091,0.2,20212022,8481546,Cam York
3,0,0,0,0.0,0.41,20202021,8481546,Cam York
63,3,12,15,0.081081,5.73,20242025,8481178,Egor Zamula
66,5,16,21,0.081967,5.79,20232024,8481178,Egor Zamula
14,0,4,4,0.0,7.4,20222023,8481178,Egor Zamula
10,0,0,0,0.0,0.2,20212022,8481178,Egor Zamula
2,0,0,0,0.0,0.41,20202021,8481178,Egor Zamula
79,5,7,12,0.066667,5.73,20242025,8478569,Noel Acciari
55,4,3,7,0.067797,5.79,20232024,8478569,Noel Acciari
23,4,1,5,0.142857,7.4,20222023,8478569,Noel Acciari
20,3,5,8,0.094,0.2,20212022,8478569,Noel Acciari
41,4,7,11,0.059,0.41,20202021,8478569,Noel Acciari
66,20,7,27,0.185,,20192020,8478569,Noel Acciari
72,6,8,14,0.0606,,20182019,8478569,Noel Acciari
60,10,1,11,0.1515,,20172018,8478569,Noel Acciari
29,2,3,5,0.0833,,20162017,8478569,Noel Acciari
19,0,1,1,0.0,,20152016,8478569,Noel Acciari
80,33,58,91,0.145374,5.73,20242025,8471675,Sidney Crosby
82,42,52,94,0.151079,5.79,20232024,8471675,Sidney Crosby
82,33,60,93,0.129412,7.4,20222023,8471675,Sidney Crosby
69,31,53,84,0.149,0.2,20212022,8471675,Sidney Crosby
55,24,38,62,0.151,0.41,20202021,8471675,Sidney Crosby
41,16,31,47,0.147,,20192020,8471675,Sidney Crosby
79,35,65,100,0.1591,,20182019,8471675,Sidney Crosby
82,29,60,89,0.1174,,20172018,8471675,Sidney Crosby
75,44,45,89,0.1725,,20162017,8471675,Sidney Crosby
80,36,49,85,0.1452,,20152016,8471675,Sidney Crosby
77,28,56,84,0.1181,,20142015,8471675,Sidney Crosby
80,36,68,104,0.139,,20132014,8471675,Sidney Crosby
36,15,41,56,0.121,,20122013,8471675,Sidney Crosby
22,8,29,37,0.1067,,20112012,8471675,Sidney Crosby
41,32,34,66,0.1988,,20102011,8471675,Sidney Crosby
81,51,58,109,0.1711,,20092010,8471675,Sidney Crosby
77,33,70,103,0.1387,,20082009,8471675,Sidney Crosby
53,24,48,72,0.1387,,20072008,8471675,Sidney Crosby
79,36,84,120,0.144,,20062007,8471675,Sidney Crosby
81,39,63,102,0.1403,,20052006,8471675,Sidney Crosby
64,13,10,23,0.132653,5.73,20242025,8475763,Kevin Hayes
79,13,16,29,0.084967,5.79,20232024,8475763,Kevin Hayes
81,18,36,54,0.086124,7.4,20222023,8475763,Kevin Hayes
48,10,21,31,0.079,0.2,20212022,8475763,Kevin Hayes
55,12,19,31,0.094,0.41,20202021,8475763,Kevin Hayes
69,23,18,41,0.131,,20192020,8475763,Kevin Hayes
20,5,8,13,0.1351,,20182019,8475763,Kevin Hayes
76,25,19,44,0.1453,,20172018,8475763,Kevin Hayes
76,17,32,49,0.1189,,20162017,8475763,Kevin Hayes
79,14,22,36,0.1053,,20152016,8475763,Kevin Hayes
79,17,28,45,0.1532,,20142015,8475763,Kevin Hayes
28,3,8,11,0.081081,5.73,20242025,8478046,Danton Heinen
74,17,19,36,0.142857,5.79,20232024,8478046,Danton Heinen
65,8,14,22,0.083333,7.4,20222023,8478046,Danton Heinen
76,18,15,33,0.13,0.2,20212022,8478046,Danton Heinen
43,7,7,14,0.092,0.41,20202021,8478046,Danton Heinen
9,3,1,4,0.158,,20192020,8478046,Danton Heinen
77,11,23,34,0.0965,,20182019,8478046,Danton Heinen
77,16,31,47,0.1185,,20172018,8478046,Danton Heinen
8,0,0,0,0.0,,20162017,8478046,Danton Heinen
59,11,9,20,0.215686,5.73,20242025,8481481,Blake Lizotte
62,7,8,15,0.092105,5.79,20232024,8481481,Blake Lizotte
81,11,23,34,0.101852,7.4,20222023,8481481,Blake Lizotte
70,10,14,24,0.11,0.2,20212022,8481481,Blake Lizotte
41,3,7,10,0.071,0.41,20202021,8481481,Blake Lizotte
65,6,17,23,0.069,,20192020,8481481,Blake Lizotte
1,0,0,0,0.0,,20182019,8481481,Blake Lizotte
68,16,34,50,0.128,5.73,20242025,8471215,Evgeni Malkin
82,27,40,67,0.135678,5.79,20232024,8471215,Evgeni Malkin
82,27,56,83,0.1125,7.4,20222023,8471215,Evgeni Malkin
41,20,22,42,0.155,0.2,20212022,8471215,Evgeni Malkin
33,8,20,28,0.111,0.41,20202021,8471215,Evgeni Malkin
55,25,49,74,0.146,,20192020,8471215,Evgeni Malkin
68,21,51,72,0.1123,,20182019,8471215,Evgeni Malkin
78,42,56,98,0.1757,,20172018,8471215,Evgeni Malkin
62,33,39,72,0.1728,,20162017,8471215,Evgeni Malkin
57,27,31,58,0.1667,,20152016,8471215,Evgeni Malkin
69,28,42,70,0.1321,,20142015,8471215,Evgeni Malkin
60,23,49,72,0.1204,,20132014,8471215,Evgeni Malkin
31,9,24,33,0.0909,,20122013,8471215,Evgeni Malkin
75,50,59,109,0.1475,,20112012,8471215,Evgeni Malkin
43,15,22,37,0.0824,,20102011,8471215,Evgeni Malkin
67,28,49,77,0.1045,,20092010,8471215,Evgeni Malkin
82,35,78,113,0.1207,,20082009,8471215,Evgeni Malkin
82,47,59,106,0.1728,,20072008,8471215,Evgeni Malkin
78,33,52,85,0.1364,,20062007,8471215,Evgeni Malkin
13,4,3,7,0.266667,5.73,20242025,8477511,Anthony Mantha
18,3,7,10,0.130435,5.79,20232024,8477511,Anthony Mantha
67,11,16,27,0.092437,7.4,20222023,8477511,Anthony Mantha
37,9,14,23,0.11,0.2,20212022,8477511,Anthony Mantha
14,4,4,8,0.105,0.41,20202021,8477511,Anthony Mantha
43,16,22,38,0.117,,20192020,8477511,Anthony Mantha
67,25,23,48,0.1263,,20182019,8477511,Anthony Mantha
80,24,24,48,0.1263,,20172018,8477511,Anthony Mantha
60,17,19,36,0.1278,,20162017,8477511,Anthony Mantha
10,2,1,3,0.1111,,20152016,8477511,Anthony Mantha
81,35,35,70,0.172414,5.73,20242025,8476483,Rickard Rakell
70,15,22,37,0.090909,5.79,20232024,8476483,Rickard Rakell
82,28,32,60,0.115226,7.4,20222023,8476483,Rickard Rakell
19,4,9,13,0.083,0.2,20212022,8476483,Rickard Rakell
52,9,19,28,0.063,0.41,20202021,8476483,Rickard Rakell
65,15,27,42,0.081,,20192020,8476483,Rickard Rakell
69,18,25,43,0.0928,,20182019,8476483,Rickard Rakell
77,34,35,69,0.1478,,20172018,8476483,Rickard Rakell
71,33,18,51,0.1864,,20162017,8476483,Rickard Rakell
72,20,23,43,0.1183,,20152016,8476483,Rickard Rakell
71,9,22,31,0.0857,,20142015,8476483,Rickard Rakell
18,0,4,4,0.0,,20132014,8476483,Rickard Rakell
4,0,0,0,0.0,,20122013,8476483,Rickard Rakell
71,31,34,65,0.162304,5.73,20242025,8475810,Bryan Rust
62,28,28,56,0.142857,5.79,20232024,8475810,Bryan Rust
81,20,26,46,0.094787,7.4,20222023,8475810,Bryan Rust
60,24,34,58,0.133,0.2,20212022,8475810,Bryan Rust
56,22,20,42,0.143,0.41,20202021,8475810,Bryan Rust
55,27,29,56,0.179,,20192020,8475810,Bryan Rust
72,18,17,35,0.1277,,20182019,8475810,Bryan Rust
69,13,25,38,0.1057,,20172018,8475810,Bryan Rust
57,15,13,28,0.1364,,20162017,8475810,Bryan Rust
41,4,7,11,0.0588,,20152016,8475810,Bryan Rust
14,1,1,2,0.0294,,20142015,8475810,Bryan Rust
73,1,15,16,0.015873,5.73,20242025,8477365,Connor Clifton
79,4,14,18,0.051948,5.79,20232024,8477365,Connor Clifton
78,5,18,23,0.053763,7.4,20222023,8477365,Connor Clifton
60,2,8,10,0.025,0.2,20212022,8477365,Connor Clifton
44,1,6,7,0.021,0.41,20202021,8477365,Connor Clifton
31,2,0,2,0.1,,20192020,8477365,Connor Clifton
19,0,1,1,0.0,,20182019,8477365,Connor Clifton
63,1,9,10,0.017544,5.73,20242025,8476856,Mathew Dumba
18,0,2,2,0.0,5.79,20232024,8476856,Mathew Dumba
79,4,10,14,0.040404,7.4,20222023,8476856,Mathew Dumba
57,7,20,27,0.06,0.2,20212022,8476856,Mathew Dumba
51,6,15,21,0.067,0.41,20202021,8476856,Mathew Dumba
69,6,18,24,0.036,,20192020,8476856,Mathew Dumba
32,12,10,22,0.129,,20182019,8476856,Mathew Dumba
82,14,36,50,0.0795,,20172018,8476856,Mathew Dumba
76,11,23,34,0.084,,20162017,8476856,Mathew Dumba
81,10,16,26,0.0658,,20152016,8476856,Mathew Dumba
58,8,8,16,0.093,,20142015,8476856,Mathew Dumba
13,1,1,2,0.0833,,20132014,8476856,Mathew Dumba
61,1,3,4,0.025641,5.73,20242025,8477435,Ryan Graves
70,3,11,14,0.038961,5.79,20232024,8477435,Ryan Graves
78,8,18,26,0.056738,7.4,20222023,8477435,Ryan Graves
75,6,22,28,0.054,0.2,20212022,8477435,Ryan Graves
54,2,13,15,0.02,0.41,20202021,8477435,Ryan Graves
69,9,17,26,0.067,,20192020,8477435,Ryan Graves
26,3,2,5,0.1154,,20182019,8477435,Ryan Graves
6,0,0,0,0.0,5.73,20242025,8478452,Caleb Jones
25,0,5,5,0.0,5.79,20232024,8478452,Caleb Jones
73,4,12,16,0.046512,7.4,20222023,8478452,Caleb Jones
51,5,10,15,0.088,0.2,20212022,8478452,Caleb Jones
33,0,4,4,0.0,0.41,20202021,8478452,Caleb Jones
43,4,5,9,0.105,,20192020,8478452,Caleb Jones
17,1,5,6,0.0476,,20182019,8478452,Caleb Jones
82,11,42,53,0.057592,5.73,20242025,8474578,Erik Karlsson
82,11,45,56,0.051643,5.79,20232024,8474578,Erik Karlsson
82,25,76,101,0.119617,7.4,20222023,8474578,Erik Karlsson
50,10,25,35,0.085,0.2,20212022,8474578,Erik Karlsson
52,8,14,22,0.073,0.41,20202021,8474578,Erik Karlsson
56,6,34,40,0.05,,20192020,8474578,Erik Karlsson
53,3,42,45,0.0178,,20182019,8474578,Erik Karlsson
71,9,53,62,0.0459,,20172018,8474578,Erik Karlsson
77,17,54,71,0.078,,20162017,8474578,Erik Karlsson
82,16,66,82,0.0645,,20152016,8474578,Erik Karlsson
82,21,45,66,0.0719,,20142015,8474578,Erik Karlsson
82,20,54,74,0.0778,,20132014,8474578,Erik Karlsson
17,6,8,14,0.0759,,20122013,8474578,Erik Karlsson
81,19,59,78,0.0728,,20112012,8474578,Erik Karlsson
75,13,32,45,0.0714,,20102011,8474578,Erik Karlsson
60,5,21,26,0.0446,,20092010,8474578,Erik Karlsson
74,9,21,30,0.054878,5.73,20242025,8471724,Kris Letang
82,10,41,51,0.060976,5.79,20232024,8471724,Kris Letang
64,12,29,41,0.074534,7.4,20222023,8471724,Kris Letang
78,10,58,68,0.047,0.2,20212022,8471724,Kris Letang
55,7,38,45,0.053,0.41,20202021,8471724,Kris Letang
61,15,29,44,0.085,,20192020,8471724,Kris Letang
65,16,40,56,0.0777,,20182019,8471724,Kris Letang
79,9,42,51,0.0405,,20172018,8471724,Kris Letang
41,5,29,34,0.041,,20162017,8471724,Kris Letang
71,16,51,67,0.0734,,20152016,8471724,Kris Letang
69,11,43,54,0.0558,,20142015,8471724,Kris Letang
37,11,11,22,0.1019,,20132014,8471724,Kris Letang
35,5,33,38,0.0526,,20122013,8471724,Kris Letang
51,10,32,42,0.0704,,20112012,8471724,Kris Letang
82,8,42,50,0.0339,,20102011,8471724,Kris Letang
73,3,24,27,0.0172,,20092010,8471724,Kris Letang
74,10,23,33,0.0725,,20082009,8471724,Kris Letang
63,6,11,17,0.0882,,20072008,8471724,Kris Letang
7,2,0,2,0.25,,20062007,8471724,Kris Letang
42,9,17,26,0.136364,5.73,20242025,8474586,Jordan Eberle
78,17,27,44,0.10119,5.79,20232024,8474586,Jordan Eberle
82,20,43,63,0.112994,7.4,20222023,8474586,Jordan Eberle
79,21,23,44,0.128,0.2,20212022,8474586,Jordan Eberle
55,16,17,33,0.125,0.41,20202021,8474586,Jordan Eberle
58,16,24,40,0.118,,20192020,8474586,Jordan Eberle
78,19,18,37,0.1188,,20182019,8474586,Jordan Eberle
81,25,34,59,0.1366,,20172018,8474586,Jordan Eberle
82,20,31,51,0.0962,,20162017,8474586,Jordan Eberle
69,25,22,47,0.1445,,20152016,8474586,Jordan Eberle
81,24,39,63,0.1311,,20142015,8474586,Jordan Eberle
80,28,37,65,0.14,,20132014,8474586,Jordan Eberle
48,16,21,37,0.1203,,20122013,8474586,Jordan Eberle
78,34,42,76,0.1889,,20112012,8474586,Jordan Eberle
69,18,25,43,0.1139,,20102011,8474586,Jordan Eberle
82,18,19,37,0.163636,5.73,20242025,8477919,Frederick Gaudreau
67,5,10,15,0.047619,5.79,20232024,8477919,Frederick Gaudreau
82,19,19,38,0.137681,7.4,20222023,8477919,Frederick Gaudreau
76,14,30,44,0.106,0.2,20212022,8477919,Frederick Gaudreau
19,2,8,10,0.1,0.41,20202021,8477919,Frederick Gaudreau
20,1,1,2,0.05,5.73,20242025,8477401,John Hayden
2,0,0,0,0.0,5.79,20232024,8477401,John Hayden
7,2,0,2,0.222222,7.4,20222023,8477401,John Hayden
55,2,2,4,0.031,0.2,20212022,8477401,John Hayden
29,2,3,5,0.095,0.41,20202021,8477401,John Hayden
43,3,1,4,0.077,,20192020,8477401,John Hayden
54,3,2,5,0.0714,,20182019,8477401,John Hayden
47,4,9,13,0.0714,,20172018,8477401,John Hayden
12,1,3,4,0.0455,,20162017,8477401,John Hayden
49,10,20,30,0.138889,5.73,20242025,8481554,Kaapo Kakko
61,13,6,19,0.142857,5.79,20232024,8481554,Kaapo Kakko
82,18,22,40,0.144,7.4,20222023,8481554,Kaapo Kakko
43,7,11,18,0.113,0.2,20212022,8481554,Kaapo Kakko
48,9,8,17,0.111,0.41,20202021,8481554,Kaapo Kakko
66,10,13,23,0.092,,20192020,8481554,Kaapo Kakko
62,22,25,47,0.164179,5.73,20242025,8478975,Mason Marchment
81,22,31,53,0.146667,5.79,20232024,8478975,Mason Marchment
68,12,19,31,0.081081,7.4,20222023,8478975,Mason Marchment
54,18,29,47,0.149,0.2,20212022,8478975,Mason Marchment
33,2,8,10,0.04,0.41,20202021,8478975,Mason Marchment
4,0,1,1,0.0,,20192020,8478975,Mason Marchment
82,22,39,61,0.108911,5.73,20242025,8477955,Jared McCann
80,29,33,62,0.134259,5.79,20232024,8477955,Jared McCann
79,40,30,70,0.190476,7.4,20222023,8477955,Jared McCann
74,27,23,50,0.136,0.2,20212022,8477955,Jared McCann
43,14,18,32,0.151,0.41,20202021,8477955,Jared McCann
66,14,21,35,0.093,,20192020,8477955,Jared McCann
32,11,6,17,0.1528,,20182019,8477955,Jared McCann
68,9,19,28,0.0629,,20172018,8477955,Jared McCann
29,1,6,7,0.0227,,20162017,8477955,Jared McCann
69,9,9,18,0.0849,,20152016,8477955,Jared McCann
81,26,23,49,0.134021,5.73,20242025,8475768,Jaden Schwartz
62,13,17,30,0.111111,5.79,20232024,8475768,Jaden Schwartz
71,21,19,40,0.125749,7.4,20222023,8475768,Jaden Schwartz
37,8,15,23,0.079,0.2,20212022,8475768,Jaden Schwartz
40,8,13,21,0.113,0.41,20202021,8475768,Jaden Schwartz
71,22,35,57,0.136,,20192020,8475768,Jaden Schwartz
69,11,25,36,0.0601,,20182019,8475768,Jaden Schwartz
62,24,35,59,0.1529,,20172018,8475768,Jaden Schwartz
78,19,36,55,0.1061,,20162017,8475768,Jaden Schwartz
33,8,14,22,0.127,,20152016,8475768,Jaden Schwartz
75,28,35,63,0.1522,,20142015,8475768,Jaden Schwartz
80,25,31,56,0.133,,20132014,8475768,Jaden Schwartz
45,7,6,13,0.14,,20122013,8475768,Jaden Schwartz
7,2,1,3,0.3333,,20112012,8475768,Jaden Schwartz
78,13,38,51,0.178082,5.73,20242025,8476905,Chandler Stephenson
75,16,35,51,0.164948,5.79,20232024,8476905,Chandler Stephenson
81,16,49,65,0.133333,7.4,20222023,8476905,Chandler Stephenson
79,21,43,64,0.168,0.2,20212022,8476905,Chandler Stephenson
51,14,21,35,0.169,0.41,20202021,8476905,Chandler Stephenson
41,8,14,22,0.145,,20192020,8476905,Chandler Stephenson
64,5,6,11,0.1389,,20182019,8476905,Chandler Stephenson
67,6,12,18,0.1667,,20172018,8476905,Chandler Stephenson
4,0,0,0,0.0,,20162017,8476905,Chandler Stephenson
9,0,0,0,0.0,,20152016,8476905,Chandler Stephenson
81,23,12,35,0.167883,5.73,20242025,8480009,Eeli Tolvanen
81,16,25,41,0.104575,5.79,20232024,8480009,Eeli Tolvanen
48,16,11,27,0.164948,7.4,20222023,8480009,Eeli Tolvanen
75,11,12,23,0.073,0.2,20212022,8480009,Eeli Tolvanen
40,11,11,22,0.169,0.41,20202021,8480009,Eeli Tolvanen
62,11,28,39,0.080292,5.73,20242025,8478407,Vince Dunn
59,11,35,46,0.091667,5.79,20232024,8478407,Vince Dunn
81,14,50,64,0.09396,7.4,20222023,8478407,Vince Dunn
73,7,28,35,0.058,0.2,20212022,8478407,Vince Dunn
43,6,14,20,0.082,0.41,20202021,8478407,Vince Dunn
71,9,14,23,0.065,,20192020,8478407,Vince Dunn
78,12,23,35,0.08,,20182019,8478407,Vince Dunn
75,5,19,24,0.0362,,20172018,8478407,Vince Dunn
14,0,1,1,0.0,5.73,20242025,8479985,Cale Fleury
1,0,0,0,0.0,5.79,20232024,8479985,Cale Fleury
12,0,1,1,0.0,7.4,20222023,8479985,Cale Fleury
9,0,0,0,0.0,0.2,20212022,8479985,Cale Fleury
82,7,21,28,0.0625,5.73,20242025,8476457,Adam Larsson
81,4,14,18,0.030769,5.79,20232024,8476457,Adam Larsson
82,8,25,33,0.055944,7.4,20222023,8476457,Adam Larsson
82,8,17,25,0.067,0.2,20212022,8476457,Adam Larsson
56,4,6,10,0.077,0.41,20202021,8476457,Adam Larsson
49,1,5,6,0.016,,20192020,8476457,Adam Larsson
82,3,17,20,0.0256,,20182019,8476457,Adam Larsson
63,4,9,13,0.0435,,20172018,8476457,Adam Larsson
79,4,15,19,0.0471,,20162017,8476457,Adam Larsson
82,3,15,18,0.0462,,20152016,8476457,Adam Larsson
64,3,21,24,0.033,,20142015,8476457,Adam Larsson
26,1,2,3,0.05,,20132014,8476457,Adam Larsson
37,0,6,6,0.0,,20122013,8476457,Adam Larsson
65,2,16,18,0.0294,,20112012,8476457,Adam Larsson
18,2,1,3,0.095238,5.73,20242025,8479324,Ryan Lindgren
76,3,14,17,0.041096,5.79,20232024,8479324,Ryan Lindgren
63,1,17,18,0.013333,7.4,20222023,8479324,Ryan Lindgren
78,4,11,15,0.055,0.2,20212022,8479324,Ryan Lindgren
51,1,15,16,0.015,0.41,20202021,8479324,Ryan Lindgren
60,1,13,14,0.021,,20192020,8479324,Ryan Lindgren
5,0,0,0,0.0,,20182019,8479324,Ryan Lindgren
64,0,9,9,0.0,5.73,20242025,8479372,Joshua Mahura
30,0,9,9,0.0,5.79,20232024,8479372,Joshua Mahura
82,4,12,16,0.051282,7.4,20222023,8479372,Joshua Mahura
38,3,4,7,0.083,0.2,20212022,8479372,Joshua Mahura
13,1,3,4,0.071,0.41,20202021,8479372,Joshua Mahura
11,1,3,4,0.091,,20192020,8479372,Joshua Mahura
17,1,4,5,0.05,,20182019,8479372,Joshua Mahura
81,18,23,41,0.077922,5.73,20242025,8477986,Brandon Montour
66,8,25,33,0.047619,5.79,20232024,8477986,Brandon Montour
80,16,57,73,0.066116,7.4,20222023,8477986,Brandon Montour
81,11,26,37,0.072,0.2,20212022,8477986,Brandon Montour
12,2,2,4,0.091,0.41,20202021,8477986,Brandon Montour
54,5,13,18,0.058,,20192020,8477986,Brandon Montour
20,3,7,10,0.0545,,20182019,8477986,Brandon Montour
80,9,23,32,0.0563,,20172018,8477986,Brandon Montour
27,2,4,6,0.04,,20162017,8477986,Brandon Montour
82,4,13,17,0.060606,5.73,20242025,8476467,Jamie Oleksiak
82,2,13,15,0.018519,5.79,20232024,8476467,Jamie Oleksiak
75,9,16,25,0.118421,7.4,20222023,8476467,Jamie Oleksiak
72,1,16,17,0.011,0.2,20212022,8476467,Jamie Oleksiak
56,6,8,14,0.071,0.41,20202021,8476467,Jamie Oleksiak
69,3,7,10,0.039,,20192020,8476467,Jamie Oleksiak
21,0,1,1,0.0,,20182019,8476467,Jamie Oleksiak
47,4,10,14,0.0625,,20172018,8476467,Jamie Oleksiak
41,5,2,7,0.1515,,20162017,8476467,Jamie Oleksiak
19,0,2,2,0.0,,20152016,8476467,Jamie Oleksiak
36,1,7,8,0.0278,,20142015,8476467,Jamie Oleksiak
7,0,0,0,0.0,,20132014,8476467,Jamie Oleksiak
16,0,2,2,0.0,,20122013,8476467,Jamie Oleksiak
68,1,7,8,0.02,5.73,20242025,8480848,Ty Dellandrea
42,2,7,9,0.037736,5.79,20232024,8480848,Ty Dellandrea
82,9,19,28,0.097826,7.4,20222023,8480848,Ty Dellandrea
1,0,0,0,0.0,0.2,20212022,8480848,Ty Dellandrea
26,3,2,5,0.097,0.41,20202021,8480848,Ty Dellandrea
81,19,7,26,0.211111,5.73,20242025,8478874,Adam Gaudette
2,0,0,0,0.0,5.79,20232024,8478874,Adam Gaudette
77,5,3,8,0.068493,5.73,20242025,8476624,Barclay Goodrow
80,4,8,12,0.065574,5.79,20232024,8476624,Barclay Goodrow
82,11,20,31,0.123596,7.4,20222023,8476624,Barclay Goodrow
79,13,20,33,0.112,0.2,20212022,8476624,Barclay Goodrow
55,6,14,20,0.083,0.41,20202021,8476624,Barclay Goodrow
8,0,2,2,0.0,,20192020,8476624,Barclay Goodrow
82,7,10,17,0.0833,,20182019,8476624,Barclay Goodrow
47,7,7,14,0.1228,,20172018,8476624,Barclay Goodrow
3,0,1,1,0.0,,20162017,8476624,Barclay Goodrow
14,0,3,3,0.0,,20152016,8476624,Barclay Goodrow
60,4,8,12,0.0588,,20142015,8476624,Barclay Goodrow
56,3,6,9,0.034091,5.73,20242025,8479336,Carl Grundstrom
50,8,4,12,0.084211,5.79,20232024,8479336,Carl Grundstrom
57,12,7,19,0.133333,7.4,20222023,8479336,Carl Grundstrom
54,9,6,15,0.108,0.2,20212022,8479336,Carl Grundstrom
47,6,5,11,0.091,0.41,20202021,8479336,Carl Grundstrom
13,0,4,4,0.0,,20192020,8479336,Carl Grundstrom
15,5,1,6,0.1923,,20182019,8479336,Carl Grundstrom
51,7,7,14,0.12963,5.73,20242025,8480798,Philipp Kurashev
75,18,36,54,0.140625,5.79,20232024,8480798,Philipp Kurashev
70,9,16,25,0.077586,7.4,20222023,8480798,Philipp Kurashev
67,6,15,21,0.07,0.2,20212022,8480798,Philipp Kurashev
54,8,8,16,0.123,0.41,20202021,8480798,Philipp Kurashev
35,0,2,2,0.0,5.73,20242025,8471817,Ryan Reaves
49,4,2,6,0.153846,5.79,20232024,8471817,Ryan Reaves
61,5,10,15,0.111111,7.4,20222023,8471817,Ryan Reaves
69,5,8,13,0.114,0.2,20212022,8471817,Ryan Reaves
37,1,4,5,0.038,0.41,20202021,8471817,Ryan Reaves
71,8,7,15,0.131,,20192020,8471817,Ryan Reaves
80,9,11,20,0.0947,,20182019,8471817,Ryan Reaves
21,0,2,2,0.0,,20172018,8471817,Ryan Reaves
80,7,6,13,0.1207,,20162017,8471817,Ryan Reaves
64,3,1,4,0.0968,,20152016,8471817,Ryan Reaves
81,6,6,12,0.1091,,20142015,8471817,Ryan Reaves
63,2,6,8,0.08,,20132014,8471817,Ryan Reaves
43,4,2,6,0.1667,,20122013,8471817,Ryan Reaves
60,3,1,4,0.0938,,20112012,8471817,Ryan Reaves
28,2,2,4,0.125,,20102011,8471817,Ryan Reaves
72,16,13,29,0.111111,5.73,20242025,8475784,Jeff Skinner
74,24,22,46,0.113744,5.79,20232024,8475784,Jeff Skinner
79,35,47,82,0.144628,7.4,20222023,8475784,Jeff Skinner
80,33,30,63,0.126,0.2,20212022,8475784,Jeff Skinner
53,7,7,14,0.063,0.41,20202021,8475784,Jeff Skinner
59,14,9,23,0.077,,20192020,8475784,Jeff Skinner
82,40,23,63,0.1493,,20182019,8475784,Jeff Skinner
82,24,25,49,0.0866,,20172018,8475784,Jeff Skinner
79,37,26,63,0.1317,,20162017,8475784,Jeff Skinner
82,28,23,51,0.1085,,20152016,8475784,Jeff Skinner
77,18,13,31,0.0766,,20142015,8475784,Jeff Skinner
71,33,21,54,0.1204,,20132014,8475784,Jeff Skinner
42,13,11,24,0.0818,,20122013,8475784,Jeff Skinner
64,20,24,44,0.0952,,20112012,8475784,Jeff Skinner
82,31,32,63,0.1442,,20102011,8475784,Jeff Skinner
78,30,24,54,0.128755,5.73,20242025,8475726,Tyler Toffoli
18,7,4,11,0.14,5.79,20232024,8475726,Tyler Toffoli
82,34,39,73,0.126866,7.4,20222023,8475726,Tyler Toffoli
37,11,12,23,0.116,0.2,20212022,8475726,Tyler Toffoli
52,28,16,44,0.177,0.41,20202021,8475726,Tyler Toffoli
10,6,4,10,0.158,,20192020,8475726,Tyler Toffoli
82,13,21,34,0.0575,,20182019,8475726,Tyler Toffoli
82,24,23,47,0.0956,,20172018,8475726,Tyler Toffoli
63,16,18,34,0.097,,20162017,8475726,Tyler Toffoli
82,31,27,58,0.1455,,20152016,8475726,Tyler Toffoli
76,23,26,49,0.115,,20142015,8475726,Tyler Toffoli
62,12,17,29,0.0968,,20132014,8475726,Tyler Toffoli
10,2,3,5,0.1,,20122013,8475726,Tyler Toffoli
77,10,25,35,0.121951,5.73,20242025,8477505,Alexander Wennberg
19,1,4,5,0.1,5.79,20232024,8477505,Alexander Wennberg
82,13,25,38,0.128713,7.4,20222023,8477505,Alexander Wennberg
80,11,26,37,0.116,0.2,20212022,8477505,Alexander Wennberg
56,17,12,29,0.207,0.41,20202021,8477505,Alexander Wennberg
57,5,17,22,0.069,,20192020,8477505,Alexander Wennberg
75,2,23,25,0.0313,,20182019,8477505,Alexander Wennberg
66,8,27,35,0.1081,,20172018,8477505,Alexander Wennberg
80,13,46,59,0.1193,,20162017,8477505,Alexander Wennberg
69,8,32,40,0.0825,,20152016,8477505,Alexander Wennberg
68,4,16,20,0.0471,,20142015,8477505,Alexander Wennberg
3,0,0,0,0.0,5.73,20242025,8478400,Colin White
17,0,0,0,0.0,5.79,20232024,8478400,Colin White
68,8,7,15,0.125,7.4,20222023,8478400,Colin White
24,3,7,10,0.064,0.2,20212022,8478400,Colin White
45,10,8,18,0.145,0.41,20202021,8478400,Colin White
61,7,16,23,0.084,,20192020,8478400,Colin White
71,14,27,41,0.1138,,20182019,8478400,Colin White
21,2,4,6,0.0833,,20172018,8478400,Colin White
2,0,0,0,0.0,,20162017,8478400,Colin White
13,1,3,4,0.066667,5.73,20242025,8479523,Lucas Carlsson
78,5,12,17,0.063291,5.73,20242025,8479983,Mario Ferraro
78,3,18,21,0.024194,5.79,20232024,8479983,Mario Ferraro
72,4,7,11,0.060606,7.4,20222023,8479983,Mario Ferraro
63,2,12,14,0.041,0.2,20212022,8479983,Mario Ferraro
56,1,16,17,0.017,0.41,20202021,8479983,Mario Ferraro
61,2,9,11,0.032,,20192020,8479983,Mario Ferraro
11,1,3,4,0.052632,5.73,20242025,8475906,John Klingberg
14,0,5,5,0.0,5.79,20232024,8475906,John Klingberg
17,2,7,9,0.058824,7.4,20222023,8475906,John Klingberg
74,6,41,47,0.043,0.2,20212022,8475906,John Klingberg
53,7,29,36,0.065,0.41,20202021,8475906,John Klingberg
58,6,26,32,0.05,,20192020,8475906,John Klingberg
64,10,35,45,0.0654,,20182019,8475906,John Klingberg
82,8,59,67,0.0392,,20172018,8475906,John Klingberg
80,13,36,49,0.1048,,20162017,8475906,John Klingberg
76,10,48,58,0.0585,,20152016,8475906,John Klingberg
65,11,29,40,0.1122,,20142015,8475906,John Klingberg
31,2,3,5,0.095238,5.73,20242025,8475181,Nick Leddy
82,3,25,28,0.036585,5.79,20232024,8475181,Nick Leddy
78,2,21,23,0.025316,7.4,20222023,8475181,Nick Leddy
20,2,6,8,0.105,0.2,20212022,8475181,Nick Leddy
56,2,29,31,0.025,0.41,20202021,8475181,Nick Leddy
60,3,18,21,0.042,,20192020,8475181,Nick Leddy
82,4,22,26,0.0345,,20182019,8475181,Nick Leddy
80,10,32,42,0.0654,,20172018,8475181,Nick Leddy
81,11,35,46,0.0803,,20162017,8475181,Nick Leddy
81,5,35,40,0.0413,,20152016,8475181,Nick Leddy
78,10,27,37,0.0833,,20142015,8475181,Nick Leddy
82,7,24,31,0.0569,,20132014,8475181,Nick Leddy
48,6,12,18,0.0923,,20122013,8475181,Nick Leddy
82,3,34,37,0.0319,,20112012,8475181,Nick Leddy
46,4,3,7,0.1081,,20102011,8475181,Nick Leddy
67,6,11,17,0.058824,5.73,20242025,8480043,Timothy Liljegren
55,3,20,23,0.048387,5.79,20232024,8480043,Timothy Liljegren
67,6,12,18,0.071429,7.4,20222023,8480043,Timothy Liljegren
61,5,18,23,0.063,0.2,20212022,8480043,Timothy Liljegren
2,0,0,0,0.0,0.41,20202021,8480043,Timothy Liljegren
11,0,1,1,0.0,,20192020,8480043,Timothy Liljegren
76,6,22,28,0.051282,5.73,20242025,8475200,Dmitry Orlov
82,6,20,26,0.046512,5.79,20232024,8475200,Dmitry Orlov
23,4,13,17,0.085106,7.4,20222023,8475200,Dmitry Orlov
76,12,23,35,0.094,0.2,20212022,8475200,Dmitry Orlov
51,8,14,22,0.096,0.41,20202021,8475200,Dmitry Orlov
69,4,23,27,0.038,,20192020,8475200,Dmitry Orlov
82,3,26,29,0.0297,,20182019,8475200,Dmitry Orlov
82,10,21,31,0.08,,20172018,8475200,Dmitry Orlov
82,6,27,33,0.048,,20162017,8475200,Dmitry Orlov
82,8,21,29,0.0889,,20152016,8475200,Dmitry Orlov
66,8,11,19,0.069565,5.73,20242025,8475760,Nick Bjugstad
76,22,23,45,0.133333,5.79,20232024,8475760,Nick Bjugstad
19,4,2,6,0.117647,7.4,20222023,8475760,Nick Bjugstad
57,7,6,13,0.086,0.2,20212022,8475760,Nick Bjugstad
44,6,11,17,0.077,0.41,20202021,8475760,Nick Bjugstad
13,1,1,2,0.056,,20192020,8475760,Nick Bjugstad
32,9,5,14,0.0957,,20182019,8475760,Nick Bjugstad
82,19,30,49,0.0826,,20172018,8475760,Nick Bjugstad
54,7,7,14,0.0769,,20162017,8475760,Nick Bjugstad
67,15,19,34,0.0877,,20152016,8475760,Nick Bjugstad
72,24,19,43,0.1159,,20142015,8475760,Nick Bjugstad
76,16,22,38,0.0865,,20132014,8475760,Nick Bjugstad
11,1,0,1,0.0588,,20122013,8475760,Nick Bjugstad
76,20,37,57,0.137931,5.73,20242025,8477402,Pavel Buchnevich
80,27,36,63,0.130435,5.79,20232024,8477402,Pavel Buchnevich
63,26,41,67,0.211382,7.4,20222023,8477402,Pavel Buchnevich
73,30,46,76,0.151,0.2,20212022,8477402,Pavel Buchnevich
54,20,28,48,0.167,0.41,20202021,8477402,Pavel Buchnevich
68,16,30,46,0.108,,20192020,8477402,Pavel Buchnevich
64,21,17,38,0.1765,,20182019,8477402,Pavel Buchnevich
74,14,29,43,0.1029,,20172018,8477402,Pavel Buchnevich
41,8,12,20,0.1455,,20162017,8477402,Pavel Buchnevich
60,4,10,14,0.057971,5.73,20242025,8478472,Mathieu Joseph
72,11,24,35,0.08871,5.79,20232024,8478472,Mathieu Joseph
56,3,15,18,0.045455,7.4,20222023,8478472,Mathieu Joseph
11,4,8,12,0.211,0.2,20212022,8478472,Mathieu Joseph
56,12,7,19,0.203,0.41,20202021,8478472,Mathieu Joseph
37,4,3,7,0.114,,20192020,8478472,Mathieu Joseph
70,13,13,26,0.1368,,20182019,8478472,Mathieu Joseph
82,36,34,70,0.150628,5.73,20242025,8479385,Jordan Kyrou
82,31,36,67,0.123506,5.79,20232024,8479385,Jordan Kyrou
79,37,36,73,0.136029,7.4,20222023,8479385,Jordan Kyrou
74,27,48,75,0.144,0.2,20212022,8479385,Jordan Kyrou
55,14,21,35,0.143,0.41,20202021,8479385,Jordan Kyrou
28,4,5,9,0.103,,20192020,8479385,Jordan Kyrou
16,1,2,3,0.0625,,20182019,8479385,Jordan Kyrou
82,18,32,50,0.124138,5.73,20242025,8475170,Brayden Schenn
82,20,26,46,0.117647,5.79,20232024,8475170,Brayden Schenn
82,21,44,65,0.145833,7.4,20222023,8475170,Brayden Schenn
62,24,34,58,0.216,0.2,20212022,8475170,Brayden Schenn
56,16,20,36,0.142,0.41,20202021,8475170,Brayden Schenn
71,25,33,58,0.181,,20192020,8475170,Brayden Schenn
72,17,37,54,0.1069,,20182019,8475170,Brayden Schenn
82,28,42,70,0.1333,,20172018,8475170,Brayden Schenn
79,25,30,55,0.1404,,20162017,8475170,Brayden Schenn
80,26,33,59,0.1461,,20152016,8475170,Brayden Schenn
82,18,29,47,0.1154,,20142015,8475170,Brayden Schenn
82,20,21,41,0.1124,,20132014,8475170,Brayden Schenn
47,8,18,26,0.1013,,20122013,8475170,Brayden Schenn
54,12,6,18,0.1237,,20112012,8475170,Brayden Schenn
8,0,2,2,0.0,,20102011,8475170,Brayden Schenn
1,0,0,0,0.0,,20092010,8475170,Brayden Schenn
67,6,14,20,0.1,5.73,20242025,8476897,Oskar Sundqvist
71,6,15,21,0.088235,5.79,20232024,8476897,Oskar Sundqvist
15,3,4,7,0.3,7.4,20222023,8476897,Oskar Sundqvist
18,4,4,8,0.2,0.2,20212022,8476897,Oskar Sundqvist
28,4,5,9,0.125,0.41,20202021,8476897,Oskar Sundqvist
57,12,11,23,0.124,,20192020,8476897,Oskar Sundqvist
74,14,17,31,0.1239,,20182019,8476897,Oskar Sundqvist
42,1,4,5,0.0244,,20172018,8476897,Oskar Sundqvist
10,0,0,0,0.0,,20162017,8476897,Oskar Sundqvist
18,1,3,4,0.0769,,20152016,8476897,Oskar Sundqvist
81,25,21,46,0.181159,5.73,20242025,8480459,Pius Suter
67,14,15,29,0.133333,5.79,20232024,8480459,Pius Suter
79,14,10,24,0.132075,7.4,20222023,8480459,Pius Suter
82,15,21,36,0.09,0.2,20212022,8480459,Pius Suter
55,14,13,27,0.125,0.41,20202021,8480459,Pius Suter
31,6,5,11,0.12,5.73,20242025,8480074,Alexandre Texier
78,12,18,30,0.110092,5.79,20232024,8480074,Alexandre Texier
70,21,60,81,0.144828,5.73,20242025,8480023,Robert Thomas
82,26,60,86,0.152941,5.79,20232024,8480023,Robert Thomas
73,18,47,65,0.169811,7.4,20222023,8480023,Robert Thomas
72,20,57,77,0.174,0.2,20212022,8480023,Robert Thomas
33,3,9,12,0.136,0.41,20202021,8480023,Robert Thomas
66,10,32,42,0.115,,20192020,8480023,Robert Thomas
70,9,24,33,0.1125,,20182019,8480023,Robert Thomas
73,8,8,16,0.111111,5.73,20242025,8477573,Nathan Walker
45,7,6,13,0.162791,5.79,20232024,8477573,Nathan Walker
56,2,8,10,0.046512,7.4,20222023,8477573,Nathan Walker
30,8,4,12,0.211,0.2,20212022,8477573,Nathan Walker
8,1,0,1,0.1,0.41,20202021,8477573,Nathan Walker
5,1,1,2,0.167,,20192020,8477573,Nathan Walker
3,0,1,1,0.0,,20182019,8477573,Nathan Walker
2,0,0,0,0.0,,20172018,8477573,Nathan Walker
78,4,28,32,0.032258,5.73,20242025,8475753,Justin Faulk
60,2,28,30,0.015152,5.79,20232024,8475753,Justin Faulk
82,11,39,50,0.056122,7.4,20222023,8475753,Justin Faulk
76,16,31,47,0.096,0.2,20212022,8475753,Justin Faulk
56,7,18,25,0.06,0.41,20202021,8475753,Justin Faulk
69,5,11,16,0.034,,20192020,8475753,Justin Faulk
82,11,24,35,0.0507,,20182019,8475753,Justin Faulk
76,8,23,31,0.0379,,20172018,8475753,Justin Faulk
75,17,20,37,0.0756,,20162017,8475753,Justin Faulk
64,16,21,37,0.087,,20152016,8475753,Justin Faulk
82,15,34,49,0.063,,20142015,8475753,Justin Faulk
76,5,27,32,0.0329,,20132014,8475753,Justin Faulk
38,5,10,15,0.0658,,20122013,8475753,Justin Faulk
66,8,14,22,0.0792,,20112012,8475753,Justin Faulk
51,9,27,36,0.126761,5.73,20242025,8475764,Cam Fowler
81,5,34,39,0.045872,5.79,20232024,8475764,Cam Fowler
82,10,38,48,0.076923,7.4,20222023,8475764,Cam Fowler
76,9,33,42,0.073,0.2,20212022,8475764,Cam Fowler
56,5,18,23,0.067,0.41,20202021,8475764,Cam Fowler
59,9,20,29,0.077,,20192020,8475764,Cam Fowler
59,5,18,23,0.0568,,20182019,8475764,Cam Fowler
67,8,24,32,0.0656,,20172018,8475764,Cam Fowler
80,11,28,39,0.0591,,20162017,8475764,Cam Fowler
69,5,23,28,0.0442,,20152016,8475764,Cam Fowler
80,7,27,34,0.0805,,20142015,8475764,Cam Fowler
70,6,30,36,0.06,,20132014,8475764,Cam Fowler
37,1,10,11,0.02,,20122013,8475764,Cam Fowler
82,5,24,29,0.0407,,20112012,8475764,Cam Fowler
76,10,30,40,0.0813,,20102011,8475764,Cam Fowler
64,16,20,36,0.128,5.73,20242025,8476892,Colton Parayko
82,10,16,26,0.064935,5.79,20232024,8476892,Colton Parayko
79,4,23,27,0.030075,7.4,20222023,8476892,Colton Parayko
80,6,29,35,0.044,0.2,20212022,8476892,Colton Parayko
32,2,10,12,0.033,0.41,20202021,8476892,Colton Parayko
64,10,18,28,0.062,,20192020,8476892,Colton Parayko
80,10,18,28,0.0568,,20182019,8476892,Colton Parayko
82,6,29,35,0.0283,,20172018,8476892,Colton Parayko
81,4,31,35,0.0213,,20162017,8476892,Colton Parayko
79,9,24,33,0.0545,,20152016,8476892,Colton Parayko
18,5,4,9,0.166667,5.73,20242025,8477416,Oliver Bjorkstrand
82,20,39,59,0.107527,5.79,20232024,8477416,Oliver Bjorkstrand
81,20,25,45,0.10101,7.4,20222023,8477416,Oliver Bjorkstrand
80,28,29,57,0.13,0.2,20212022,8477416,Oliver Bjorkstrand
56,18,26,44,0.126,0.41,20202021,8477416,Oliver Bjorkstrand
49,21,15,36,0.13,,20192020,8477416,Oliver Bjorkstrand
77,23,13,36,0.1429,,20182019,8477416,Oliver Bjorkstrand
82,11,29,40,0.0675,,20172018,8477416,Oliver Bjorkstrand
26,6,7,13,0.1091,,20162017,8477416,Oliver Bjorkstrand
12,4,4,8,0.16,,20152016,8477416,Oliver Bjorkstrand
80,27,32,59,0.16875,5.73,20242025,8478519,Anthony Cirelli
79,20,25,45,0.155039,5.79,20232024,8478519,Anthony Cirelli
58,11,18,29,0.099099,7.4,20222023,8478519,Anthony Cirelli
76,17,26,43,0.116,0.2,20212022,8478519,Anthony Cirelli
50,9,13,22,0.12,0.41,20202021,8478519,Anthony Cirelli
68,16,28,44,0.142,,20192020,8478519,Anthony Cirelli
82,19,20,39,0.1545,,20182019,8478519,Anthony Cirelli
18,5,6,11,0.1923,,20172018,8478519,Anthony Cirelli
82,2,4,6,0.024096,5.73,20242025,8476878,Zemgus Girgensons
63,8,6,14,0.109589,5.79,20232024,8476878,Zemgus Girgensons
80,10,8,18,0.087719,7.4,20222023,8476878,Zemgus Girgensons
56,10,8,18,0.109,0.2,20212022,8476878,Zemgus Girgensons
21,1,13,14,0.028571,5.73,20242025,8476826,Yanni Gourde
80,11,22,33,0.070513,5.79,20232024,8476826,Yanni Gourde
81,14,34,48,0.099291,7.4,20222023,8476826,Yanni Gourde
74,21,27,48,0.165,0.2,20212022,8476826,Yanni Gourde
56,17,19,36,0.144,0.41,20202021,8476826,Yanni Gourde
70,10,20,30,0.091,,20192020,8476826,Yanni Gourde
80,22,26,48,0.1692,,20182019,8476826,Yanni Gourde
82,25,39,64,0.1838,,20172018,8476826,Yanni Gourde
20,6,2,8,0.2,,20162017,8476826,Yanni Gourde
2,0,1,1,0.0,,20152016,8476826,Yanni Gourde
80,41,39,80,0.18894,5.73,20242025,8477404,Jake Guentzel
17,8,17,25,0.150943,5.79,20232024,8477404,Jake Guentzel
78,36,37,73,0.147541,7.4,20222023,8477404,Jake Guentzel
76,40,44,84,0.152,0.2,20212022,8477404,Jake Guentzel
56,23,34,57,0.163,0.41,20202021,8477404,Jake Guentzel
39,20,23,43,0.157,,20192020,8477404,Jake Guentzel
82,40,36,76,0.1762,,20182019,8477404,Jake Guentzel
82,22,26,48,0.1287,,20172018,8477404,Jake Guentzel
40,16,17,33,0.1975,,20162017,8477404,Jake Guentzel
82,35,55,90,0.153509,5.73,20242025,8479542,Brandon Hagel
82,26,49,75,0.141304,5.79,20232024,8479542,Brandon Hagel
81,30,34,64,0.168539,7.4,20222023,8479542,Brandon Hagel
22,4,3,7,0.129,0.2,20212022,8479542,Brandon Hagel
52,9,15,24,0.099,0.41,20202021,8479542,Brandon Hagel
1,0,0,0,0.0,,20192020,8479542,Brandon Hagel
78,37,84,121,0.139623,5.73,20242025,8476453,Nikita Kucherov
81,44,100,144,0.143791,5.79,20232024,8476453,Nikita Kucherov
82,30,83,113,0.110701,7.4,20222023,8476453,Nikita Kucherov
47,25,44,69,0.16,0.2,20212022,8476453,Nikita Kucherov
76,22,19,41,0.156028,5.73,20242025,8477426,Nick Paul
82,24,22,46,0.156863,5.79,20232024,8477426,Nick Paul
80,17,15,32,0.141667,7.4,20222023,8477426,Nick Paul
21,5,9,14,0.143,0.2,20212022,8477426,Nick Paul
56,5,15,20,0.048,0.41,20202021,8477426,Nick Paul
56,9,11,20,0.087,,20192020,8477426,Nick Paul
20,1,1,2,0.0333,,20182019,8477426,Nick Paul
11,1,0,1,0.0909,,20172018,8477426,Nick Paul
1,0,0,0,0.0,,20162017,8477426,Nick Paul
24,2,3,5,0.0714,,20152016,8477426,Nick Paul
77,42,40,82,0.222222,5.73,20242025,8478010,Brayden Point
81,46,44,90,0.202643,5.79,20232024,8478010,Brayden Point
82,51,44,95,0.217021,7.4,20222023,8478010,Brayden Point
66,28,30,58,0.159,0.2,20212022,8478010,Brayden Point
56,23,25,48,0.176,0.41,20202021,8478010,Brayden Point
66,25,39,64,0.177,,20192020,8478010,Brayden Point
79,41,51,92,0.2147,,20182019,8478010,Brayden Point
82,32,34,66,0.1475,,20172018,8478010,Brayden Point
68,18,22,40,0.1475,,20162017,8478010,Brayden Point
1,0,0,0,0.0,5.73,20242025,8477149,Scott Sabourin
3,0,0,0,0.0,5.79,20232024,8477149,Scott Sabourin
76,3,18,21,0.046875,5.73,20242025,8478416,Erik Cernak
69,2,11,13,0.037736,5.79,20232024,8478416,Erik Cernak
70,2,14,16,0.022989,7.4,20222023,8478416,Erik Cernak
55,1,12,13,0.012,0.2,20212022,8478416,Erik Cernak
46,5,13,18,0.059,0.41,20202021,8478416,Erik Cernak
67,5,7,12,0.04,,20192020,8478416,Erik Cernak
58,5,11,16,0.0467,,20182019,8478416,Erik Cernak
79,15,51,66,0.082873,5.73,20242025,8475167,Victor Hedman
78,13,63,76,0.077381,5.79,20232024,8475167,Victor Hedman
76,9,40,49,0.048649,7.4,20222023,8475167,Victor Hedman
82,20,65,85,0.091,0.2,20212022,8475167,Victor Hedman
54,9,36,45,0.066,0.41,20202021,8475167,Victor Hedman
66,11,44,55,0.071,,20192020,8475167,Victor Hedman
70,12,42,54,0.0659,,20182019,8475167,Victor Hedman
77,17,46,63,0.0787,,20172018,8475167,Victor Hedman
79,16,56,72,0.0964,,20162017,8475167,Victor Hedman
78,10,37,47,0.0556,,20152016,8475167,Victor Hedman
59,10,28,38,0.087,,20142015,8475167,Victor Hedman
75,13,42,55,0.0765,,20132014,8475167,Victor Hedman
44,4,16,20,0.0526,,20122013,8475167,Victor Hedman
61,5,18,23,0.061,,20112012,8475167,Victor Hedman
79,3,23,26,0.0297,,20102011,8475167,Victor Hedman
74,4,16,20,0.0444,,20092010,8475167,Victor Hedman
82,4,27,31,0.051282,5.73,20242025,8474151,Ryan McDonagh
74,3,29,32,0.032967,5.79,20232024,8474151,Ryan McDonagh
71,2,18,20,0.025641,7.4,20222023,8474151,Ryan McDonagh
71,4,22,26,0.047,0.2,20212022,8474151,Ryan McDonagh
50,4,8,12,0.047,0.41,20202021,8474151,Ryan McDonagh
50,1,11,12,0.02,,20192020,8474151,Ryan McDonagh
82,9,37,46,0.0703,,20182019,8474151,Ryan McDonagh
14,2,1,3,0.0909,,20172018,8474151,Ryan McDonagh
77,6,36,42,0.0392,,20162017,8474151,Ryan McDonagh
73,9,25,34,0.0796,,20152016,8474151,Ryan McDonagh
71,8,25,33,0.0541,,20142015,8474151,Ryan McDonagh
77,14,29,43,0.0791,,20132014,8474151,Ryan McDonagh
47,4,15,19,0.0482,,20122013,8474151,Ryan McDonagh
82,7,25,32,0.0569,,20112012,8474151,Ryan McDonagh
40,1,8,9,0.037,,20102011,8474151,Ryan McDonagh
1,0,0,0,0.0,5.73,20242025,8477463,Steven Santini
3,0,0,0,0.0,5.73,20242025,8476329,Travis Boyd
16,2,6,8,0.166667,5.79,20232024,8476329,Travis Boyd
82,15,19,34,0.159574,7.4,20222023,8476329,Travis Boyd
74,17,18,35,0.193,0.2,20212022,8476329,Travis Boyd
19,2,0,2,0.25,0.41,20202021,8476329,Travis Boyd
24,3,7,10,0.115,,20192020,8476329,Travis Boyd
53,5,15,20,0.1429,,20182019,8476329,Travis Boyd
8,0,1,1,0.0,,20172018,8476329,Travis Boyd
74,8,25,33,0.086022,5.73,20242025,8477503,Max Domi
80,9,38,47,0.065693,5.79,20232024,8477503,Max Domi
20,2,5,7,0.055556,7.4,20222023,8477503,Max Domi
19,2,5,7,0.074,0.2,20212022,8477503,Max Domi
54,9,15,24,0.091,0.41,20202021,8477503,Max Domi
71,17,27,44,0.095,,20192020,8477503,Max Domi
82,28,44,72,0.1379,,20182019,8477503,Max Domi
82,9,36,45,0.06,,20172018,8477503,Max Domi
59,9,29,38,0.0833,,20162017,8477503,Max Domi
81,18,34,52,0.1154,,20152016,8477503,Max Domi
19,1,6,7,0.111111,5.73,20242025,8475714,Calle Jarnkrok
52,10,11,21,0.108696,5.79,20232024,8475714,Calle Jarnkrok
73,20,19,39,0.188679,7.4,20222023,8475714,Calle Jarnkrok
17,0,4,4,0.0,0.2,20212022,8475714,Calle Jarnkrok
49,13,15,28,0.143,0.41,20202021,8475714,Calle Jarnkrok
64,15,19,34,0.11,,20192020,8475714,Calle Jarnkrok
79,10,16,26,0.0943,,20182019,8475714,Calle Jarnkrok
68,16,19,35,0.1524,,20172018,8475714,Calle Jarnkrok
81,15,16,31,0.1119,,20162017,8475714,Calle Jarnkrok
81,16,14,30,0.128,,20152016,8475714,Calle Jarnkrok
74,7,11,18,0.0737,,20142015,8475714,Calle Jarnkrok
12,2,7,9,0.1538,,20132014,8475714,Calle Jarnkrok
57,7,7,14,0.134615,5.73,20242025,8478057,Dakota Joshua
63,18,14,32,0.214286,5.79,20232024,8478057,Dakota Joshua
79,11,12,23,0.15493,7.4,20222023,8478057,Dakota Joshua
30,3,5,8,0.097,0.2,20212022,8478057,Dakota Joshua
12,1,0,1,0.111,0.41,20202021,8478057,Dakota Joshua
59,5,8,13,0.111111,5.73,20242025,8480144,David Kampf
78,8,11,19,0.101266,5.79,20232024,8480144,David Kampf
82,7,20,27,0.065421,7.4,20222023,8480144,David Kampf
82,11,15,26,0.108,0.2,20212022,8480144,David Kampf
56,1,11,12,0.016,0.41,20202021,8480144,David Kampf
70,8,8,16,0.089,,20192020,8480144,David Kampf
63,4,15,19,0.0556,,20182019,8480144,David Kampf
46,4,7,11,0.087,,20172018,8480144,David Kampf
20,2,2,4,0.1,5.73,20242025,8476872,Scott Laughton
82,13,26,39,0.077844,5.79,20232024,8476872,Scott Laughton
78,18,25,43,0.105882,7.4,20222023,8476872,Scott Laughton
67,11,19,30,0.1,0.2,20212022,8476872,Scott Laughton
53,9,11,20,0.101,0.41,20202021,8476872,Scott Laughton
49,13,14,27,0.176,,20192020,8476872,Scott Laughton
82,12,20,32,0.0923,,20182019,8476872,Scott Laughton
81,10,10,20,0.0926,,20172018,8476872,Scott Laughton
2,0,0,0,0.0,,20162017,8476872,Scott Laughton
71,7,14,21,0.0824,,20152016,8476872,Scott Laughton
31,2,4,6,0.0392,,20142015,8476872,Scott Laughton
26,3,2,5,0.057692,5.73,20242025,8479968,Vinni Lettieri
46,5,4,9,0.106383,5.79,20232024,8479968,Vinni Lettieri
1,0,0,0,0.0,7.4,20222023,8479968,Vinni Lettieri
31,5,5,10,0.1,0.2,20212022,8479968,Vinni Lettieri
5,0,0,0,0.0,0.41,20202021,8479968,Vinni Lettieri
80,8,11,19,0.105263,5.73,20242025,8478904,Steven Lorentz
38,1,2,3,0.033333,5.79,20232024,8478904,Steven Lorentz
80,10,9,19,0.09009,7.4,20222023,8478904,Steven Lorentz
67,8,5,13,0.1,0.2,20212022,8478904,Steven Lorentz
45,2,6,8,0.05,0.41,20202021,8478904,Steven Lorentz
67,33,45,78,0.126437,5.73,20242025,8479318,Auston Matthews
81,69,38,107,0.186992,5.79,20232024,8479318,Auston Matthews
74,40,45,85,0.122324,7.4,20222023,8479318,Auston Matthews
73,60,46,106,0.172,0.2,20212022,8479318,Auston Matthews
52,41,25,66,0.185,0.41,20202021,8479318,Auston Matthews
70,47,33,80,0.162,,20192020,8479318,Auston Matthews
68,37,36,73,0.1474,,20182019,8479318,Auston Matthews
62,34,29,63,0.1818,,20172018,8479318,Auston Matthews
82,40,29,69,0.1434,,20162017,8479318,Auston Matthews
82,45,39,84,0.177866,5.73,20242025,8477939,William Nylander
82,40,58,98,0.126582,5.79,20232024,8477939,William Nylander
82,40,47,87,0.136519,7.4,20222023,8477939,William Nylander
81,34,46,80,0.133,0.2,20212022,8477939,William Nylander
51,17,25,42,0.128,0.41,20202021,8477939,William Nylander
68,31,28,59,0.157,,20192020,8477939,William Nylander
54,7,20,27,0.0538,,20182019,8477939,William Nylander
82,20,41,61,0.1087,,20172018,8477939,William Nylander
81,22,39,61,0.1073,,20162017,8477939,William Nylander
22,6,7,13,0.1395,,20152016,8477939,William Nylander
69,15,7,22,0.133929,5.73,20242025,8481582,Nicholas Robertson
56,14,13,27,0.145833,5.79,20232024,8481582,Nicholas Robertson
15,2,3,5,0.074074,7.4,20222023,8481582,Nicholas Robertson
10,1,0,1,0.071,0.2,20212022,8481582,Nicholas Robertson
6,0,1,1,0.0,0.41,20202021,8481582,Nicholas Robertson
71,15,16,31,0.140187,5.73,20242025,8478462,Nicolas Roy
70,13,28,41,0.116071,5.79,20232024,8478462,Nicolas Roy
65,14,16,30,0.138614,7.4,20222023,8478462,Nicolas Roy
78,15,24,39,0.103,0.2,20212022,8478462,Nicolas Roy
50,6,9,15,0.115,0.41,20202021,8478462,Nicolas Roy
28,5,5,10,0.119,,20192020,8478462,Nicolas Roy
6,0,0,0,0.0,,20182019,8478462,Nicolas Roy
1,0,0,0,0.0,,20172018,8478462,Nicolas Roy
75,38,36,74,0.19,5.73,20242025,8475166,John Tavares
80,29,36,65,0.103943,5.79,20232024,8475166,John Tavares
80,36,44,80,0.129964,7.4,20222023,8475166,John Tavares
79,27,49,76,0.114,0.2,20212022,8475166,John Tavares
56,19,31,50,0.117,0.41,20202021,8475166,John Tavares
63,26,34,60,0.132,,20192020,8475166,John Tavares
82,47,41,88,0.1643,,20182019,8475166,John Tavares
82,37,47,84,0.144,,20172018,8475166,John Tavares
77,28,38,66,0.1077,,20162017,8475166,John Tavares
78,33,37,70,0.132,,20152016,8475166,John Tavares
82,38,48,86,0.1367,,20142015,8475166,John Tavares
59,24,42,66,0.1277,,20132014,8475166,John Tavares
48,28,19,47,0.1728,,20122013,8475166,John Tavares
82,31,50,81,0.1084,,20112012,8475166,John Tavares
79,29,38,67,0.1193,,20102011,8475166,John Tavares
82,24,30,54,0.129,,20092010,8475166,John Tavares
7,0,0,0,0.0,5.73,20242025,8476988,Matt Benning
14,0,2,2,0.0,5.79,20232024,8476988,Matt Benning
77,1,23,24,0.017241,7.4,20222023,8476988,Matt Benning
65,0,11,11,0.0,0.2,20212022,8476988,Matt Benning
53,1,3,4,0.023,0.41,20202021,8476988,Matt Benning
43,1,7,8,0.026,,20192020,8476988,Matt Benning
70,5,12,17,0.0532,,20182019,8476988,Matt Benning
73,6,15,21,0.0541,,20172018,8476988,Matt Benning
62,3,12,15,0.0435,,20162017,8476988,Matt Benning
78,1,9,10,0.020833,5.73,20242025,8481122,Simon Benoit
64,1,4,5,0.019231,5.79,20232024,8481122,Simon Benoit
78,3,7,10,0.036585,7.4,20222023,8481122,Simon Benoit
53,1,4,5,0.022,0.2,20212022,8481122,Simon Benoit
6,0,0,0,0.0,0.41,20202021,8481122,Simon Benoit
20,0,3,3,0.0,5.73,20242025,8478443,Brandon Carlo
76,4,10,14,0.050633,5.79,20232024,8478443,Brandon Carlo
75,3,13,16,0.031915,7.4,20222023,8478443,Brandon Carlo
79,6,9,15,0.048,0.2,20212022,8478443,Brandon Carlo
27,3,1,4,0.07,0.41,20202021,8478443,Brandon Carlo
67,4,15,19,0.036,,20192020,8478443,Brandon Carlo
72,2,8,10,0.0172,,20182019,8478443,Brandon Carlo
76,0,6,6,0.0,,20172018,8478443,Brandon Carlo
82,6,10,16,0.0682,,20162017,8478443,Brandon Carlo
77,4,25,29,0.033898,5.73,20242025,8475171,Oliver Ekman-Larsson
80,9,23,32,0.073171,5.79,20232024,8475171,Oliver Ekman-Larsson
54,2,20,22,0.022222,7.4,20222023,8475171,Oliver Ekman-Larsson
79,5,24,29,0.03,0.2,20212022,8475171,Oliver Ekman-Larsson
46,3,21,24,0.036,0.41,20202021,8475171,Oliver Ekman-Larsson
66,9,21,30,0.067,,20192020,8475171,Oliver Ekman-Larsson
81,14,30,44,0.0795,,20182019,8475171,Oliver Ekman-Larsson
82,14,28,42,0.0693,,20172018,8475171,Oliver Ekman-Larsson
79,12,27,39,0.0828,,20162017,8475171,Oliver Ekman-Larsson
75,21,34,55,0.0921,,20152016,8475171,Oliver Ekman-Larsson
82,23,20,43,0.0871,,20142015,8475171,Oliver Ekman-Larsson
80,15,29,44,0.0754,,20132014,8475171,Oliver Ekman-Larsson
48,3,21,24,0.0297,,20122013,8475171,Oliver Ekman-Larsson
82,13,19,32,0.0884,,20112012,8475171,Oliver Ekman-Larsson
48,1,10,11,0.02,,20102011,8475171,Oliver Ekman-Larsson
66,2,21,23,0.027027,5.73,20242025,8476931,Jake McCabe
73,8,20,28,0.109589,5.79,20232024,8476931,Jake McCabe
21,1,4,5,0.034483,7.4,20222023,8476931,Jake McCabe
75,4,18,22,0.05,0.2,20212022,8476931,Jake McCabe
13,1,2,3,0.067,0.41,20202021,8476931,Jake McCabe
66,3,10,13,0.04,,20192020,8476931,Jake McCabe
59,4,10,14,0.0625,,20182019,8476931,Jake McCabe
53,3,9,12,0.0566,,20172018,8476931,Jake McCabe
76,3,17,20,0.038,,20162017,8476931,Jake McCabe
77,4,10,14,0.0645,,20152016,8476931,Jake McCabe
2,0,0,0,0.0,,20142015,8476931,Jake McCabe
7,0,1,1,0.0,,20132014,8476931,Jake McCabe
3,0,1,1,0.0,5.73,20242025,8477541,Dakota Mermis
47,3,5,8,0.071429,5.79,20232024,8477541,Dakota Mermis
2,0,0,0,0.0,7.4,20222023,8477541,Dakota Mermis
2,0,0,0,0.0,0.2,20212022,8477541,Dakota Mermis
3,0,0,0,0.0,0.41,20202021,8477541,Dakota Mermis
10,1,3,4,0.059,,20192020,8477541,Dakota Mermis
1,0,0,0,0.0,,20182019,8477541,Dakota Mermis
9,0,0,0,0.0,,20172018,8477541,Dakota Mermis
36,2,3,5,0.043478,5.73,20242025,8479026,Philippe Myers
5,0,0,0,0.0,5.79,20232024,8479026,Philippe Myers
11,1,2,3,0.047619,7.4,20222023,8479026,Philippe Myers
27,1,3,4,0.036,0.2,20212022,8479026,Philippe Myers
44,1,10,11,0.013,0.41,20202021,8479026,Philippe Myers
50,4,12,16,0.051,,20192020,8479026,Philippe Myers
21,1,1,2,0.04,,20182019,8479026,Philippe Myers
82,7,34,41,0.055556,5.73,20242025,8476853,Morgan Rielly
72,7,51,58,0.040462,5.79,20232024,8476853,Morgan Rielly
65,4,37,41,0.031746,7.4,20222023,8476853,Morgan Rielly
82,10,58,68,0.045,0.2,20212022,8476853,Morgan Rielly
55,5,30,35,0.05,0.41,20202021,8476853,Morgan Rielly
47,3,24,27,0.024,,20192020,8476853,Morgan Rielly
82,20,52,72,0.0897,,20182019,8476853,Morgan Rielly
76,6,46,52,0.033,,20172018,8476853,Morgan Rielly
76,6,21,27,0.0351,,20162017,8476853,Morgan Rielly
82,9,27,36,0.0539,,20152016,8476853,Morgan Rielly
81,8,21,29,0.0541,,20142015,8476853,Morgan Rielly
73,2,25,27,0.0208,,20132014,8476853,Morgan Rielly
75,3,15,18,0.069767,5.73,20242025,8475690,Chris Tanev
19,1,4,5,0.076923,5.79,20232024,8475690,Chris Tanev
65,1,12,13,0.013333,7.4,20222023,8475690,Chris Tanev
82,6,22,28,0.068,0.2,20212022,8475690,Chris Tanev
56,2,10,12,0.03,0.41,20202021,8475690,Chris Tanev
69,2,18,20,0.044,,20192020,8475690,Chris Tanev
55,2,10,12,0.0392,,20182019,8475690,Chris Tanev
42,2,9,11,0.0645,,20172018,8475690,Chris Tanev
53,2,8,10,0.0513,,20162017,8475690,Chris Tanev
69,4,14,18,0.0952,,20152016,8475690,Chris Tanev
70,2,18,20,0.0377,,20142015,8475690,Chris Tanev
64,6,11,17,0.0923,,20132014,8475690,Chris Tanev
38,2,5,7,0.1,,20122013,8475690,Chris Tanev
25,0,2,2,0.0,,20112012,8475690,Chris Tanev
29,0,1,1,0.0,,20102011,8475690,Chris Tanev
81,12,6,18,0.095238,5.73,20242025,8478474,Lawson Crouse
81,23,19,42,0.134503,5.79,20232024,8478474,Lawson Crouse
77,24,21,45,0.15894,7.4,20222023,8478474,Lawson Crouse
65,20,14,34,0.153,0.2,20212022,8478474,Lawson Crouse
51,4,9,13,0.057,0.41,20202021,8478474,Lawson Crouse
66,15,10,25,0.138,,20192020,8478474,Lawson Crouse
81,11,14,25,0.084,,20182019,8478474,Lawson Crouse
11,1,0,1,0.0769,,20172018,8478474,Lawson Crouse
72,5,7,12,0.0595,,20162017,8478474,Lawson Crouse
82,20,26,46,0.129032,5.73,20242025,8480849,Barrett Hayton
33,3,7,10,0.045455,5.79,20232024,8480849,Barrett Hayton
82,19,24,43,0.106742,7.4,20222023,8480849,Barrett Hayton
60,10,14,24,0.122,0.2,20212022,8480849,Barrett Hayton
14,2,1,3,0.2,0.41,20202021,8480849,Barrett Hayton
20,1,3,4,0.037,,20192020,8480849,Barrett Hayton
81,30,60,90,0.137615,5.73,20242025,8479343,Clayton Keller
78,33,43,76,0.144737,5.79,20232024,8479343,Clayton Keller
82,37,49,86,0.165919,7.4,20222023,8479343,Clayton Keller
67,28,35,63,0.158,0.2,20212022,8479343,Clayton Keller
56,14,21,35,0.113,0.41,20202021,8479343,Clayton Keller
70,17,27,44,0.092,,20192020,8479343,Clayton Keller
82,14,33,47,0.07,,20182019,8479343,Clayton Keller
82,23,42,65,0.1085,,20172018,8479343,Clayton Keller
3,0,2,2,0.0,,20162017,8479343,Clayton Keller
81,11,17,28,0.108911,5.73,20242025,8477021,Alexander Kerfoot
82,13,32,45,0.126214,5.79,20232024,8477021,Alexander Kerfoot
82,10,22,32,0.075188,7.4,20222023,8477021,Alexander Kerfoot
82,13,38,51,0.111,0.2,20212022,8477021,Alexander Kerfoot
56,8,15,23,0.118,0.41,20202021,8477021,Alexander Kerfoot
65,9,19,28,0.102,,20192020,8477021,Alexander Kerfoot
78,15,27,42,0.1293,,20182019,8477021,Alexander Kerfoot
79,19,24,43,0.2346,,20172018,8477021,Alexander Kerfoot
28,0,2,2,0.0,5.73,20242025,8477070,Liam O'Brien
75,5,9,14,0.069444,5.79,20232024,8477070,Liam O'Brien
56,3,8,11,0.076923,7.4,20222023,8477070,Liam O'Brien
39,2,1,3,0.056,0.2,20212022,8477070,Liam O'Brien
12,0,3,3,0.0,0.41,20202021,8477070,Liam O'Brien
82,20,43,63,0.107527,5.73,20242025,8477951,Nick Schmaltz
79,22,39,61,0.139241,5.79,20232024,8477951,Nick Schmaltz
63,22,36,58,0.166667,7.4,20222023,8477951,Nick Schmaltz
63,23,36,59,0.187,0.2,20212022,8477951,Nick Schmaltz
52,10,22,32,0.095,0.41,20202021,8477951,Nick Schmaltz
70,11,34,45,0.116,,20192020,8477951,Nick Schmaltz
17,5,9,14,0.1724,,20182019,8477951,Nick Schmaltz
78,21,31,52,0.178,,20172018,8477951,Nick Schmaltz
61,6,22,28,0.0909,,20162017,8477951,Nick Schmaltz
82,14,14,28,0.137255,5.73,20242025,8478831,Kevin Stenlund
81,11,4,15,0.135802,5.79,20232024,8478831,Kevin Stenlund
54,6,3,9,0.095238,7.4,20222023,8478831,Kevin Stenlund
3,0,0,0,0.0,0.2,20212022,8478831,Kevin Stenlund
32,5,5,10,0.119,0.41,20202021,8478831,Kevin Stenlund
32,6,4,10,0.105,,20192020,8478831,Kevin Stenlund
4,0,0,0,0.0,,20182019,8478831,Kevin Stenlund
19,1,4,5,0.071429,5.73,20242025,8479293,Brandon Tanev
66,7,9,16,0.09589,5.79,20232024,8479293,Brandon Tanev
82,16,19,35,0.13913,7.4,20222023,8479293,Brandon Tanev
30,9,6,15,0.176,0.2,20212022,8479293,Brandon Tanev
32,7,9,16,0.163,0.41,20202021,8479293,Brandon Tanev
68,11,14,25,0.116,,20192020,8479293,Brandon Tanev
80,14,15,29,0.1102,,20182019,8479293,Brandon Tanev
61,8,10,18,0.1013,,20172018,8479293,Brandon Tanev
51,2,2,4,0.037,,20162017,8479293,Brandon Tanev
3,0,0,0,0.0,,20152016,8479293,Brandon Tanev
12,2,1,3,0.153846,5.73,20242025,8479977,Kailer Yamamoto
59,8,8,16,0.131148,5.79,20232024,8479977,Kailer Yamamoto
58,10,15,25,0.103093,7.4,20222023,8479977,Kailer Yamamoto
81,20,21,41,0.175,0.2,20212022,8479977,Kailer Yamamoto
52,8,13,21,0.116,0.41,20202021,8479977,Kailer Yamamoto
27,11,15,26,0.25,,20192020,8479977,Kailer Yamamoto
17,1,1,2,0.0769,,20182019,8479977,Kailer Yamamoto
9,0,3,3,0.0,,20172018,8479977,Kailer Yamamoto
82,1,16,17,0.015152,5.73,20242025,8474013,Ian Cole
78,2,9,11,0.032787,5.79,20232024,8474013,Ian Cole
78,3,14,17,0.027523,7.4,20222023,8474013,Ian Cole
75,2,17,19,0.026,0.2,20212022,8474013,Ian Cole
52,1,7,8,0.036,0.41,20202021,8474013,Ian Cole
65,4,22,26,0.043,,20192020,8474013,Ian Cole
71,2,13,15,0.0244,,20182019,8474013,Ian Cole
20,2,5,7,0.0952,,20172018,8474013,Ian Cole
81,5,21,26,0.0562,,20162017,8474013,Ian Cole
70,0,12,12,0.0,,20152016,8474013,Ian Cole
20,1,7,8,0.0323,,20142015,8474013,Ian Cole
46,3,8,11,0.0667,,20132014,8474013,Ian Cole
15,0,1,1,0.0,,20122013,8474013,Ian Cole
26,1,5,6,0.0556,,20112012,8474013,Ian Cole
26,1,3,4,0.0455,,20102011,8474013,Ian Cole
35,1,13,14,0.033333,5.73,20242025,8478507,John Marino
75,4,21,25,0.070175,5.79,20232024,8478507,John Marino
64,4,14,18,0.059701,7.4,20222023,8478507,John Marino
81,1,24,25,0.011,0.2,20212022,8478507,John Marino
52,3,10,13,0.054,0.41,20202021,8478507,John Marino
56,6,20,26,0.098,,20192020,8478507,John Marino
70,2,16,18,0.028571,5.73,20242025,8476874,Olli Määttä
72,4,14,18,0.083333,5.79,20232024,8476874,Olli Määttä
78,6,17,23,0.096774,7.4,20222023,8476874,Olli Määttä
66,1,7,8,0.016,0.2,20212022,8476874,Olli Määttä
41,0,4,4,0.0,0.41,20202021,8476874,Olli Määttä
65,4,13,17,0.05,,20192020,8476874,Olli Määttä
60,1,13,14,0.0135,,20182019,8476874,Olli Määttä
82,7,22,29,0.0427,,20172018,8476874,Olli Määttä
55,1,6,7,0.0152,,20162017,8476874,Olli Määttä
67,6,13,19,0.0632,,20152016,8476874,Olli Määttä
20,1,8,9,0.037,,20142015,8476874,Olli Määttä
78,9,20,29,0.0756,,20132014,8476874,Olli Määttä
80,5,14,19,0.071429,5.73,20242025,8477220,Nate Schmidt
63,2,12,14,0.026667,5.79,20232024,8477220,Nate Schmidt
71,7,12,19,0.069307,7.4,20222023,8477220,Nate Schmidt
77,4,28,32,0.034,0.2,20212022,8477220,Nate Schmidt
54,5,10,15,0.066,0.41,20202021,8477220,Nate Schmidt
59,7,24,31,0.063,,20192020,8477220,Nate Schmidt
61,9,21,30,0.0804,,20182019,8477220,Nate Schmidt
76,5,31,36,0.0485,,20172018,8477220,Nate Schmidt
60,3,14,17,0.05,,20162017,8477220,Nate Schmidt
72,2,14,16,0.025,,20152016,8477220,Nate Schmidt
39,1,3,4,0.025,,20142015,8477220,Nate Schmidt
29,2,4,6,0.0488,,20132014,8477220,Nate Schmidt
77,15,38,53,0.113636,5.73,20242025,8479410,Mikhail Sergachev
34,2,17,19,0.037736,5.79,20232024,8479410,Mikhail Sergachev
79,10,54,64,0.064103,7.4,20222023,8479410,Mikhail Sergachev
78,7,31,38,0.047,0.2,20212022,8479410,Mikhail Sergachev
56,4,26,30,0.037,0.41,20202021,8479410,Mikhail Sergachev
70,10,24,34,0.085,,20192020,8479410,Mikhail Sergachev
75,6,26,32,0.0469,,20182019,8479410,Mikhail Sergachev
79,9,31,40,0.0638,,20172018,8479410,Mikhail Sergachev
4,0,0,0,0.0,,20162017,8479410,Mikhail Sergachev
43,2,3,5,0.05,5.73,20242025,8479976,Juuso Välimäki
68,2,15,17,0.028986,5.79,20232024,8479976,Juuso Välimäki
78,4,30,34,0.043011,7.4,20222023,8479976,Juuso Välimäki
9,0,2,2,0.0,0.2,20212022,8479976,Juuso Välimäki
49,2,9,11,0.028,0.41,20202021,8479976,Juuso Välimäki
82,8,18,26,0.085106,5.73,20242025,8476927,Teddy Blueger
68,6,22,28,0.061856,5.79,20232024,8476927,Teddy Blueger
18,2,4,6,0.086957,7.4,20222023,8476927,Teddy Blueger
65,9,19,28,0.097,0.2,20212022,8476927,Teddy Blueger
43,7,15,22,0.143,0.41,20202021,8476927,Teddy Blueger
69,9,13,22,0.088,,20192020,8476927,Teddy Blueger
28,6,4,10,0.1818,,20182019,8476927,Teddy Blueger
75,25,25,50,0.172414,5.73,20242025,8478444,Brock Boeser
81,40,33,73,0.196078,5.79,20232024,8478444,Brock Boeser
74,18,37,55,0.101124,7.4,20222023,8478444,Brock Boeser
71,23,23,46,0.118,0.2,20212022,8478444,Brock Boeser
56,23,26,49,0.163,0.41,20202021,8478444,Brock Boeser
57,16,29,45,0.095,,20192020,8478444,Brock Boeser
69,26,30,56,0.1244,,20182019,8478444,Brock Boeser
62,29,26,55,0.162,,20172018,8478444,Brock Boeser
9,4,1,5,0.16,,20162017,8478444,Brock Boeser
15,2,4,6,0.045455,5.73,20242025,8480078,Filip Chytil
10,0,6,6,0.0,5.79,20232024,8480078,Filip Chytil
74,22,23,45,0.124294,7.4,20222023,8480078,Filip Chytil
67,8,14,22,0.059,0.2,20212022,8480078,Filip Chytil
42,8,14,22,0.105,0.41,20202021,8480078,Filip Chytil
60,14,9,23,0.123,,20192020,8480078,Filip Chytil
75,11,12,23,0.0827,,20182019,8480078,Filip Chytil
9,1,2,3,0.0476,,20172018,8480078,Filip Chytil
82,28,20,48,0.163743,5.73,20242025,8478498,Jake DeBrusk
80,19,21,40,0.103825,5.79,20232024,8478498,Jake DeBrusk
64,27,23,50,0.141361,7.4,20222023,8478498,Jake DeBrusk
77,25,17,42,0.136,0.2,20212022,8478498,Jake DeBrusk
41,5,9,14,0.054,0.41,20202021,8478498,Jake DeBrusk
65,19,16,35,0.118,,20192020,8478498,Jake DeBrusk
68,27,15,42,0.1731,,20182019,8478498,Jake DeBrusk
70,16,27,43,0.1119,,20172018,8478498,Jake DeBrusk
81,19,31,50,0.111111,5.73,20242025,8478856,Conor Garland
82,20,27,47,0.1,5.79,20232024,8478856,Conor Garland
81,17,29,46,0.101796,7.4,20222023,8478856,Conor Garland
77,19,33,52,0.094,0.2,20212022,8478856,Conor Garland
49,12,27,39,0.089,0.41,20202021,8478856,Conor Garland
68,22,17,39,0.139,,20192020,8478856,Conor Garland
47,13,5,18,0.1102,,20182019,8478856,Conor Garland
72,8,17,25,0.096386,5.73,20242025,8481535,Nils Hoglander
80,24,12,36,0.2,5.79,20232024,8481535,Nils Hoglander
25,3,6,9,0.103448,7.4,20222023,8481535,Nils Hoglander
60,10,8,18,0.076,0.2,20212022,8481535,Nils Hoglander
56,13,14,27,0.11,0.41,20202021,8481535,Nils Hoglander
31,4,5,9,0.114286,5.73,20242025,8482055,Drew O'Connor
79,16,17,33,0.1,5.79,20232024,8482055,Drew O'Connor
46,5,6,11,0.080645,7.4,20222023,8482055,Drew O'Connor
22,3,2,5,0.075,0.2,20212022,8482055,Drew O'Connor
10,0,1,1,0.0,0.41,20202021,8482055,Drew O'Connor
64,15,30,45,0.137615,5.73,20242025,8480012,Elias Pettersson
82,34,55,89,0.164251,5.79,20232024,8480012,Elias Pettersson
80,39,63,102,0.151751,7.4,20222023,8480012,Elias Pettersson
80,32,36,68,0.167,0.2,20212022,8480012,Elias Pettersson
26,10,11,21,0.159,0.41,20202021,8480012,Elias Pettersson
68,27,39,66,0.167,,20192020,8480012,Elias Pettersson
71,28,38,66,0.1944,,20182019,8480012,Elias Pettersson
78,19,21,40,0.134752,5.73,20242025,8480748,Kiefer Sherwood
68,10,17,27,0.090909,5.79,20232024,8480748,Kiefer Sherwood
32,7,6,13,0.122807,7.4,20222023,8480748,Kiefer Sherwood
11,1,1,2,0.111,0.2,20212022,8480748,Kiefer Sherwood
16,0,3,3,0.0,0.41,20202021,8480748,Kiefer Sherwood
10,0,1,1,0.0,,20192020,8480748,Kiefer Sherwood
50,6,6,12,0.1,,20182019,8480748,Kiefer Sherwood
3,0,0,0,0.0,5.73,20242025,8478465,Guillaume Brisebois
54,2,9,11,0.051282,5.73,20242025,8475762,Derek Forbort
35,0,4,4,0.0,5.79,20232024,8475762,Derek Forbort
54,5,7,12,0.131579,7.4,20222023,8475762,Derek Forbort
76,4,10,14,0.063,0.2,20212022,8475762,Derek Forbort
56,2,10,12,0.03,0.41,20202021,8475762,Derek Forbort
7,0,0,0,0.0,,20192020,8475762,Derek Forbort
81,2,12,14,0.0267,,20182019,8475762,Derek Forbort
78,1,17,18,0.0128,,20172018,8475762,Derek Forbort
82,2,16,18,0.02,,20162017,8475762,Derek Forbort
14,1,1,2,0.0714,,20152016,8475762,Derek Forbort
61,5,28,33,0.060241,5.73,20242025,8479425,Filip Hronek
81,5,43,48,0.033784,5.79,20232024,8479425,Filip Hronek
4,0,1,1,0.0,7.4,20222023,8479425,Filip Hronek
78,5,33,38,0.038,0.2,20212022,8479425,Filip Hronek
56,2,24,26,0.018,0.41,20202021,8479425,Filip Hronek
65,9,22,31,0.072,,20192020,8479425,Filip Hronek
46,5,18,23,0.0685,,20182019,8479425,Filip Hronek
68,16,60,76,0.083333,5.73,20242025,8480800,Quinn Hughes
82,17,75,92,0.085427,5.79,20232024,8480800,Quinn Hughes
78,7,69,76,0.045455,7.4,20222023,8480800,Quinn Hughes
76,8,60,68,0.053,0.2,20212022,8480800,Quinn Hughes
56,3,38,41,0.031,0.41,20202021,8480800,Quinn Hughes
68,8,45,53,0.063,,20192020,8480800,Quinn Hughes
5,0,3,3,0.0,,20182019,8480800,Quinn Hughes
24,0,1,1,0.0,5.73,20242025,8480058,P.O Joseph
52,2,9,11,0.047619,5.79,20232024,8480058,P.O Joseph
75,5,16,21,0.046296,7.4,20222023,8480058,P.O Joseph
4,0,0,0,0.0,0.2,20212022,8480058,P.O Joseph
16,1,4,5,0.037,0.41,20202021,8480058,P.O Joseph
71,6,18,24,0.068966,5.73,20242025,8474574,Tyler Myers
77,5,24,29,0.053763,5.79,20232024,8474574,Tyler Myers
78,1,16,17,0.01,7.4,20222023,8474574,Tyler Myers
82,1,17,18,0.008,0.2,20212022,8474574,Tyler Myers
55,6,15,21,0.055,0.41,20202021,8474574,Tyler Myers
68,6,15,21,0.045,,20192020,8474574,Tyler Myers
80,9,22,31,0.0577,,20182019,8474574,Tyler Myers
82,6,30,36,0.04,,20172018,8474574,Tyler Myers
11,2,3,5,0.125,,20162017,8474574,Tyler Myers
73,9,18,27,0.0643,,20152016,8474574,Tyler Myers
24,3,12,15,0.0577,,20142015,8474574,Tyler Myers
62,9,13,22,0.0909,,20132014,8474574,Tyler Myers
39,3,5,8,0.0625,,20122013,8474574,Tyler Myers
55,8,15,23,0.0952,,20112012,8474574,Tyler Myers
80,10,27,37,0.082,,20102011,8474574,Tyler Myers
82,11,37,48,0.1058,,20092010,8474574,Tyler Myers
31,1,10,11,0.037037,5.73,20242025,8477969,Marcus Pettersson
82,4,26,30,0.037736,5.79,20232024,8477969,Marcus Pettersson
68,1,23,24,0.010417,7.4,20222023,8477969,Marcus Pettersson
72,2,17,19,0.024,0.2,20212022,8477969,Marcus Pettersson
47,2,7,9,0.043,0.41,20202021,8477969,Marcus Pettersson
69,2,20,22,0.025,,20192020,8477969,Marcus Pettersson
57,2,17,19,0.0278,,20182019,8477969,Marcus Pettersson
22,1,3,4,0.0625,,20172018,8477969,Marcus Pettersson
70,23,28,51,0.207207,5.73,20242025,8477964,Ivan Barbashev
82,19,26,45,0.155738,5.79,20232024,8477964,Ivan Barbashev
23,6,10,16,0.171429,7.4,20222023,8477964,Ivan Barbashev
81,26,34,60,0.234,0.2,20212022,8477964,Ivan Barbashev
38,5,7,12,0.116,0.41,20202021,8477964,Ivan Barbashev
69,11,15,26,0.147,,20192020,8477964,Ivan Barbashev
80,14,12,26,0.2333,,20182019,8477964,Ivan Barbashev
53,7,6,13,0.1556,,20172018,8477964,Ivan Barbashev
30,5,7,12,0.25,,20162017,8477964,Ivan Barbashev
77,28,66,94,0.120172,5.73,20242025,8478403,Jack Eichel
63,31,37,68,0.111511,5.79,20232024,8478403,Jack Eichel
67,27,39,66,0.121076,7.4,20222023,8478403,Jack Eichel
34,14,11,25,0.105,0.2,20212022,8478403,Jack Eichel
21,2,16,18,0.033,0.41,20202021,8478403,Jack Eichel
68,36,42,78,0.159,,20192020,8478403,Jack Eichel
77,28,54,82,0.0924,,20182019,8478403,Jack Eichel
67,25,39,64,0.1016,,20172018,8478403,Jack Eichel
61,24,33,57,0.0964,,20162017,8478403,Jack Eichel
81,24,32,56,0.1008,,20152016,8478403,Jack Eichel
73,32,29,61,0.180791,5.73,20242025,8476881,Tomas Hertl
6,2,2,4,0.181818,5.79,20232024,8476881,Tomas Hertl
79,22,41,63,0.120219,7.4,20222023,8476881,Tomas Hertl
82,30,34,64,0.146,0.2,20212022,8476881,Tomas Hertl
50,19,24,43,0.17,0.41,20202021,8476881,Tomas Hertl
48,16,20,36,0.137,,20192020,8476881,Tomas Hertl
77,35,39,74,0.1989,,20182019,8476881,Tomas Hertl
79,22,24,46,0.1257,,20172018,8476881,Tomas Hertl
49,10,12,22,0.1,,20162017,8476881,Tomas Hertl
81,21,25,46,0.104,,20152016,8476881,Tomas Hertl
82,13,18,31,0.0897,,20142015,8476881,Tomas Hertl
37,15,10,25,0.1531,,20132014,8476881,Tomas Hertl
80,23,17,40,0.184,5.73,20242025,8479353,Brett Howden
72,8,11,19,0.105263,5.79,20232024,8479353,Brett Howden
54,6,7,13,0.113208,7.4,20222023,8479353,Brett Howden
47,9,11,20,0.231,0.2,20212022,8479353,Brett Howden
42,1,6,7,0.03,0.41,20202021,8479353,Brett Howden
70,9,10,19,0.141,,20192020,8479353,Brett Howden
66,6,17,23,0.0811,,20182019,8479353,Brett Howden
53,9,20,29,0.07563,5.73,20242025,8476448,William Karlsson
70,30,30,60,0.171429,5.79,20232024,8476448,William Karlsson
82,14,39,53,0.086957,7.4,20222023,8476448,William Karlsson
67,12,23,35,0.089,0.2,20212022,8476448,William Karlsson
56,14,25,39,0.126,0.41,20202021,8476448,William Karlsson
63,15,31,46,0.109,,20192020,8476448,William Karlsson
82,24,32,56,0.142,,20182019,8476448,William Karlsson
82,43,35,78,0.2337,,20172018,8476448,William Karlsson
81,6,19,25,0.0625,,20162017,8476448,William Karlsson
81,9,11,20,0.0833,,20152016,8476448,William Karlsson
3,1,1,2,0.2,,20142015,8476448,William Karlsson
82,12,18,30,0.136364,5.73,20242025,8478434,Keegan Kolesar
79,8,10,18,0.109589,5.79,20232024,8478434,Keegan Kolesar
74,8,10,18,0.126984,7.4,20222023,8478434,Keegan Kolesar
77,7,17,24,0.074,0.2,20212022,8478434,Keegan Kolesar
44,3,10,13,0.065,0.41,20202021,8478434,Keegan Kolesar
1,0,0,0,0.0,,20192020,8478434,Keegan Kolesar
81,27,75,102,0.156069,5.73,20242025,8478483,Mitch Marner
69,26,59,85,0.164557,5.79,20232024,8478483,Mitch Marner
80,30,69,99,0.153061,7.4,20222023,8478483,Mitch Marner
72,35,62,97,0.156,0.2,20212022,8478483,Mitch Marner
55,20,47,67,0.128,0.41,20202021,8478483,Mitch Marner
59,16,51,67,0.104,,20192020,8478483,Mitch Marner
82,26,68,94,0.1116,,20182019,8478483,Mitch Marner
82,22,47,69,0.1134,,20172018,8478483,Mitch Marner
77,19,42,61,0.108,,20162017,8478483,Mitch Marner
29,6,8,14,0.115385,5.73,20242025,8476438,Brandon Saad
82,26,16,42,0.180556,5.79,20232024,8476438,Brandon Saad
71,19,18,37,0.149606,7.4,20222023,8476438,Brandon Saad
78,24,25,49,0.152,0.2,20212022,8476438,Brandon Saad
44,15,9,24,0.221,0.41,20202021,8476438,Brandon Saad
58,21,12,33,0.15,,20192020,8476438,Brandon Saad
80,23,24,47,0.1179,,20182019,8476438,Brandon Saad
82,18,17,35,0.0759,,20172018,8476438,Brandon Saad
82,24,29,53,0.1143,,20162017,8476438,Brandon Saad
78,31,22,53,0.133,,20152016,8476438,Brandon Saad
82,23,29,52,0.1133,,20142015,8476438,Brandon Saad
78,19,28,47,0.1195,,20132014,8476438,Brandon Saad
46,10,17,27,0.102,,20122013,8476438,Brandon Saad
2,0,0,0,0.0,,20112012,8476438,Brandon Saad
72,7,14,21,0.0875,5.73,20242025,8476925,Colton Sissons
81,15,20,35,0.114504,5.79,20232024,8476925,Colton Sissons
82,12,18,30,0.137931,7.4,20222023,8476925,Colton Sissons
79,7,21,28,0.08,0.2,20212022,8476925,Colton Sissons
54,8,7,15,0.138,0.41,20202021,8476925,Colton Sissons
57,9,6,15,0.173,,20192020,8476925,Colton Sissons
75,15,15,30,0.1351,,20182019,8476925,Colton Sissons
81,9,18,27,0.075,,20172018,8476925,Colton Sissons
58,8,2,10,0.1905,,20162017,8476925,Colton Sissons
34,4,2,6,0.16,,20152016,8476925,Colton Sissons
21,3,8,11,0.075,5.73,20242025,8475191,Reilly Smith
76,13,27,40,0.085526,5.79,20232024,8475191,Reilly Smith
78,26,30,56,0.144444,7.4,20222023,8475191,Reilly Smith
56,16,22,38,0.107,0.2,20212022,8475191,Reilly Smith
53,14,11,25,0.113,0.41,20202021,8475191,Reilly Smith
71,27,27,54,0.16,,20192020,8475191,Reilly Smith
74,19,34,53,0.1067,,20182019,8475191,Reilly Smith
67,22,38,60,0.1358,,20172018,8475191,Reilly Smith
80,15,22,37,0.0938,,20162017,8475191,Reilly Smith
82,25,25,50,0.1445,,20152016,8475191,Reilly Smith
81,13,27,40,0.0909,,20142015,8475191,Reilly Smith
82,20,31,51,0.137,,20132014,8475191,Reilly Smith
37,3,6,9,0.0882,,20122013,8475191,Reilly Smith
3,0,0,0,0.0,,20112012,8475191,Reilly Smith
66,19,48,67,0.145038,5.73,20242025,8475913,Mark Stone
56,16,37,53,0.136752,5.79,20232024,8475913,Mark Stone
43,17,21,38,0.150442,7.4,20222023,8475913,Mark Stone
37,9,21,30,0.127,0.2,20212022,8475913,Mark Stone
55,21,40,61,0.214,0.41,20202021,8475913,Mark Stone
65,21,42,63,0.125,,20192020,8475913,Mark Stone
18,5,6,11,0.0926,,20182019,8475913,Mark Stone
58,20,42,62,0.1515,,20172018,8475913,Mark Stone
71,22,32,54,0.1642,,20162017,8475913,Mark Stone
75,23,38,61,0.1523,,20152016,8475913,Mark Stone
80,26,38,64,0.1656,,20142015,8475913,Mark Stone
19,4,4,8,0.1111,,20132014,8475913,Mark Stone
4,0,0,0,0.0,,20122013,8475913,Mark Stone
6,0,0,0,0.0,5.73,20242025,8479639,Dylan Coghlan
1,0,0,0,0.0,5.79,20232024,8479639,Dylan Coghlan
17,0,3,3,0.0,7.4,20222023,8479639,Dylan Coghlan
59,3,10,13,0.028,0.2,20212022,8479639,Dylan Coghlan
29,3,3,6,0.097,0.41,20202021,8479639,Dylan Coghlan
80,10,29,39,0.068966,5.73,20242025,8478396,Noah Hanifin
19,2,10,12,0.04878,5.79,20232024,8478396,Noah Hanifin
81,7,31,38,0.039773,7.4,20222023,8478396,Noah Hanifin
81,10,38,48,0.053,0.2,20212022,8478396,Noah Hanifin
47,4,11,15,0.045,0.41,20202021,8478396,Noah Hanifin
70,5,17,22,0.038,,20192020,8478396,Noah Hanifin
80,5,28,33,0.0431,,20182019,8478396,Noah Hanifin
79,10,22,32,0.0606,,20172018,8478396,Noah Hanifin
81,4,25,29,0.037,,20162017,8478396,Noah Hanifin
79,4,18,22,0.0328,,20152016,8478396,Noah Hanifin
11,0,2,2,0.0,5.73,20242025,8477018,Ben Hutton
41,2,8,10,0.029851,5.79,20232024,8477018,Ben Hutton
31,3,5,8,0.057692,7.4,20222023,8477018,Ben Hutton
58,3,10,13,0.038,0.2,20212022,8477018,Ben Hutton
4,0,0,0,0.0,0.41,20202021,8477018,Ben Hutton
65,4,12,16,0.035,,20192020,8477018,Ben Hutton
69,5,15,20,0.0439,,20182019,8477018,Ben Hutton
61,0,6,6,0.0,,20172018,8477018,Ben Hutton
71,5,14,19,0.0385,,20162017,8477018,Ben Hutton
75,1,24,25,0.0096,,20152016,8477018,Ben Hutton
28,0,1,1,0.0,5.73,20242025,8478468,Jeremy Lauzon
79,6,8,14,0.058252,5.79,20232024,8478468,Jeremy Lauzon
67,3,9,12,0.038961,7.4,20222023,8478468,Jeremy Lauzon
13,1,0,1,0.059,0.2,20212022,8478468,Jeremy Lauzon
41,1,7,8,0.021,0.41,20202021,8478468,Jeremy Lauzon
19,1,1,2,0.05,,20192020,8478468,Jeremy Lauzon
16,1,0,1,0.0909,,20182019,8478468,Jeremy Lauzon
82,5,15,20,0.051546,5.73,20242025,8475188,Brayden McNabb
82,4,22,26,0.046512,5.79,20232024,8475188,Brayden McNabb
82,1,16,17,0.011236,7.4,20222023,8475188,Brayden McNabb
69,3,15,18,0.035,0.2,20212022,8475188,Brayden McNabb
41,2,6,8,0.051,0.41,20202021,8475188,Brayden McNabb
71,2,7,9,0.027,,20192020,8475188,Brayden McNabb
81,4,12,16,0.0476,,20182019,8475188,Brayden McNabb
76,5,10,15,0.0568,,20172018,8475188,Brayden McNabb
49,2,2,4,0.0426,,20162017,8475188,Brayden McNabb
81,2,12,14,0.022,,20152016,8475188,Brayden McNabb
71,2,22,24,0.027,,20142015,8475188,Brayden McNabb
12,0,0,0,0.0,,20132014,8475188,Brayden McNabb
8,0,0,0,0.0,5.73,20242025,8477034,Jaycob Megna
44,0,2,2,0.0,5.79,20232024,8477034,Jaycob Megna
6,0,0,0,0.0,7.4,20222023,8477034,Jaycob Megna
44,2,6,8,0.05,0.2,20212022,8477034,Jaycob Megna
67,7,50,57,0.054688,5.73,20242025,8477447,Shea Theodore
47,5,37,42,0.047619,5.79,20232024,8477447,Shea Theodore
55,8,33,41,0.058824,7.4,20222023,8477447,Shea Theodore
78,14,38,52,0.068,0.2,20212022,8477447,Shea Theodore
53,8,34,42,0.05,0.41,20202021,8477447,Shea Theodore
71,13,33,46,0.059,,20192020,8477447,Shea Theodore
79,12,25,37,0.0594,,20182019,8477447,Shea Theodore
61,6,23,29,0.0417,,20172018,8477447,Shea Theodore
34,2,7,9,0.0333,,20162017,8477447,Shea Theodore
19,3,5,8,0.1071,,20152016,8477447,Shea Theodore
74,4,9,13,0.055556,5.73,20242025,8480727,Zach Whitecloud
61,2,12,14,0.039216,5.79,20232024,8480727,Zach Whitecloud
59,5,7,12,0.078125,7.4,20222023,8480727,Zach Whitecloud
59,8,11,19,0.085,0.2,20212022,8480727,Zach Whitecloud
51,2,10,12,0.037,0.41,20202021,8480727,Zach Whitecloud
16,0,1,1,0.0,,20192020,8480727,Zach Whitecloud
7,0,1,1,0.0,5.73,20242025,8479994,Jaret Anderson-Dolan
1,0,0,0,0.0,5.79,20232024,8479994,Jaret Anderson-Dolan
46,7,5,12,0.12963,7.4,20222023,8479994,Jaret Anderson-Dolan
7,0,0,0,0.0,0.2,20212022,8479994,Jaret Anderson-Dolan
34,7,4,11,0.189,0.41,20202021,8479994,Jaret Anderson-Dolan
4,0,0,0,0.0,,20192020,8479994,Jaret Anderson-Dolan
5,0,1,1,0.0,,20182019,8479994,Jaret Anderson-Dolan
74,8,7,15,0.086957,5.73,20242025,8480289,Morgan Barron
80,11,7,18,0.117021,5.79,20232024,8480289,Morgan Barron
70,8,13,21,0.071429,7.4,20222023,8480289,Morgan Barron
14,2,2,4,0.083,0.2,20212022,8480289,Morgan Barron
5,1,0,1,0.333,0.41,20202021,8480289,Morgan Barron
82,41,56,97,0.153558,5.73,20242025,8478398,Kyle Connor
65,34,27,61,0.153846,5.79,20232024,8478398,Kyle Connor
82,31,49,80,0.113553,7.4,20222023,8478398,Kyle Connor
79,47,46,93,0.148,0.2,20212022,8478398,Kyle Connor
56,26,24,50,0.157,0.41,20202021,8478398,Kyle Connor
71,38,35,73,0.159,,20192020,8478398,Kyle Connor
82,34,32,66,0.1498,,20182019,8478398,Kyle Connor
76,31,26,57,0.1615,,20172018,8478398,Kyle Connor
20,2,3,5,0.0833,,20162017,8478398,Kyle Connor
20,1,5,6,0.043478,5.73,20242025,8476858,Phillip Di Giuseppe
51,5,5,10,0.096154,5.79,20232024,8476858,Phillip Di Giuseppe
30,6,6,12,0.084507,7.4,20222023,8476858,Phillip Di Giuseppe
36,2,4,6,0.066667,5.73,20242025,8481019,David Gustafsson
39,3,4,7,0.111111,5.79,20232024,8481019,David Gustafsson
46,0,6,6,0.0,7.4,20222023,8481019,David Gustafsson
2,0,0,0,0.0,0.2,20212022,8481019,David Gustafsson
4,0,0,0,0.0,0.41,20202021,8481019,David Gustafsson
22,1,0,1,0.25,,20192020,8481019,David Gustafsson
82,15,16,31,0.137615,5.73,20242025,8480113,Alex Iafallo
82,11,16,27,0.091667,5.79,20232024,8480113,Alex Iafallo
59,14,22,36,0.105263,7.4,20222023,8480113,Alex Iafallo
79,17,20,37,0.079,0.2,20212022,8480113,Alex Iafallo
55,13,17,30,0.11,0.41,20202021,8480113,Alex Iafallo
70,17,26,43,0.12,,20192020,8480113,Alex Iafallo
82,15,18,33,0.1014,,20182019,8480113,Alex Iafallo
75,9,16,25,0.0698,,20172018,8480113,Alex Iafallo
73,16,18,34,0.161616,5.73,20242025,8476392,Adam Lowry
81,12,23,35,0.10084,5.79,20232024,8476392,Adam Lowry
82,13,23,36,0.103175,7.4,20222023,8476392,Adam Lowry
79,13,8,21,0.113,0.2,20212022,8476392,Adam Lowry
52,10,14,24,0.125,0.41,20202021,8476392,Adam Lowry
49,4,6,10,0.059,,20192020,8476392,Adam Lowry
78,12,11,23,0.1143,,20182019,8476392,Adam Lowry
45,8,13,21,0.1143,,20172018,8476392,Adam Lowry
82,15,14,29,0.123,,20162017,8476392,Adam Lowry
74,7,10,17,0.0959,,20152016,8476392,Adam Lowry
80,11,12,23,0.1058,,20142015,8476392,Adam Lowry
78,11,27,38,0.117021,5.73,20242025,8476480,Vladislav Namestnikov
78,11,26,37,0.115789,5.79,20232024,8476480,Vladislav Namestnikov
20,2,8,10,0.055556,7.4,20222023,8476480,Vladislav Namestnikov
15,3,2,5,0.3,0.2,20212022,8476480,Vladislav Namestnikov
53,8,9,17,0.092,0.41,20202021,8476480,Vladislav Namestnikov
9,4,2,6,0.4,,20192020,8476480,Vladislav Namestnikov
78,11,20,31,0.0924,,20182019,8476480,Vladislav Namestnikov
19,2,2,4,0.0714,,20172018,8476480,Vladislav Namestnikov
74,10,18,28,0.0877,,20162017,8476480,Vladislav Namestnikov
80,14,21,35,0.1321,,20152016,8476480,Vladislav Namestnikov
43,9,7,16,0.1957,,20142015,8476480,Vladislav Namestnikov
4,0,0,0,0.0,,20132014,8476480,Vladislav Namestnikov
82,17,20,37,0.113333,5.73,20242025,8475799,Nino Niederreiter
77,18,16,34,0.105882,5.79,20232024,8475799,Nino Niederreiter
22,6,7,13,0.117647,7.4,20222023,8475799,Nino Niederreiter
75,24,20,44,0.167,0.2,20212022,8475799,Nino Niederreiter
56,20,14,34,0.159,0.41,20202021,8475799,Nino Niederreiter
67,11,18,29,0.096,,20192020,8475799,Nino Niederreiter
36,14,16,30,0.1359,,20182019,8475799,Nino Niederreiter
63,18,14,32,0.1353,,20172018,8475799,Nino Niederreiter
82,25,32,57,0.1344,,20162017,8475799,Nino Niederreiter
82,20,23,43,0.1258,,20152016,8475799,Nino Niederreiter
80,24,13,37,0.1611,,20142015,8475799,Nino Niederreiter
81,14,22,36,0.0979,,20132014,8475799,Nino Niederreiter
22,2,5,7,0.0625,5.73,20242025,8474679,Gustav Nyquist
81,23,52,75,0.150327,5.79,20232024,8474679,Gustav Nyquist
3,1,4,5,0.2,7.4,20222023,8474679,Gustav Nyquist
82,18,35,53,0.148,0.2,20212022,8474679,Gustav Nyquist
78,12,15,27,0.110092,5.73,20242025,8476871,Tanner Pearson
54,5,8,13,0.064935,5.79,20232024,8476871,Tanner Pearson
14,1,4,5,0.058824,7.4,20222023,8476871,Tanner Pearson
68,14,20,34,0.088,0.2,20212022,8476871,Tanner Pearson
51,10,8,18,0.091,0.41,20202021,8476871,Tanner Pearson
69,21,24,45,0.128,,20192020,8476871,Tanner Pearson
19,9,3,12,0.2143,,20182019,8476871,Tanner Pearson
82,15,25,40,0.0833,,20172018,8476871,Tanner Pearson
80,24,20,44,0.1283,,20162017,8476871,Tanner Pearson
79,15,21,36,0.1095,,20152016,8476871,Tanner Pearson
42,12,4,16,0.1765,,20142015,8476871,Tanner Pearson
25,3,4,7,0.0968,,20132014,8476871,Tanner Pearson
82,39,48,87,0.21547,5.73,20242025,8476460,Mark Scheifele
74,25,47,72,0.162338,5.79,20232024,8476460,Mark Scheifele
81,42,26,68,0.203883,7.4,20222023,8476460,Mark Scheifele
67,29,41,70,0.182,0.2,20212022,8476460,Mark Scheifele
56,21,42,63,0.167,0.41,20202021,8476460,Mark Scheifele
71,29,44,73,0.171,,20192020,8476460,Mark Scheifele
82,38,46,84,0.191,,20182019,8476460,Mark Scheifele
60,23,37,60,0.184,,20172018,8476460,Mark Scheifele
79,32,50,82,0.2,,20162017,8476460,Mark Scheifele
71,29,32,61,0.1495,,20152016,8476460,Mark Scheifele
82,15,34,49,0.0882,,20142015,8476460,Mark Scheifele
63,13,21,34,0.13,,20132014,8476460,Mark Scheifele
4,0,0,0,0.0,,20122013,8476460,Mark Scheifele
7,1,0,1,0.2,,20112012,8476460,Mark Scheifele
71,27,34,61,0.207692,5.73,20242025,8480014,Gabriel Vilardi
47,22,14,36,0.188034,5.79,20232024,8480014,Gabriel Vilardi
63,23,18,41,0.188525,7.4,20222023,8480014,Gabriel Vilardi
25,5,2,7,0.122,0.2,20212022,8480014,Gabriel Vilardi
54,10,13,23,0.154,0.41,20202021,8480014,Gabriel Vilardi
10,3,4,7,0.158,,20192020,8480014,Gabriel Vilardi
82,3,16,19,0.04,5.73,20242025,8476331,Dylan DeMelo
82,3,28,31,0.036145,5.79,20232024,8476331,Dylan DeMelo
75,6,21,27,0.064516,7.4,20222023,8476331,Dylan DeMelo
76,1,12,13,0.013,0.2,20212022,8476331,Dylan DeMelo
52,0,9,9,0.0,0.41,20202021,8476331,Dylan DeMelo
10,0,0,0,0.0,,20192020,8476331,Dylan DeMelo
77,4,18,22,0.0367,,20182019,8476331,Dylan DeMelo
63,0,20,20,0.0,,20172018,8476331,Dylan DeMelo
25,1,7,8,0.0313,,20162017,8476331,Dylan DeMelo
45,2,2,4,0.0476,,20152016,8476331,Dylan DeMelo
39,0,7,7,0.0,5.73,20242025,8477938,Haydn Fleury
24,1,4,5,0.04,5.79,20232024,8477938,Haydn Fleury
29,0,1,1,0.0,7.4,20222023,8477938,Haydn Fleury
36,2,2,4,0.038,0.2,20212022,8477938,Haydn Fleury
12,2,1,3,0.143,0.41,20202021,8477938,Haydn Fleury
45,4,10,14,0.062,,20192020,8477938,Haydn Fleury
20,0,1,1,0.0,,20182019,8477938,Haydn Fleury
67,0,8,8,0.0,,20172018,8477938,Haydn Fleury
18,0,1,1,0.0,5.73,20242025,8481572,Ville Heinola
60,4,11,15,0.058824,5.73,20242025,8476525,Colin Miller
5,0,1,1,0.0,5.79,20232024,8476525,Colin Miller
79,6,15,21,0.056604,7.4,20222023,8476525,Colin Miller
38,2,12,14,0.042,0.2,20212022,8476525,Colin Miller
48,4,8,12,0.063,0.41,20202021,8476525,Colin Miller
51,1,10,11,0.013,,20192020,8476525,Colin Miller
65,3,26,29,0.0229,,20182019,8476525,Colin Miller
82,10,31,41,0.0565,,20172018,8476525,Colin Miller
61,6,7,13,0.0706,,20162017,8476525,Colin Miller
42,3,13,16,0.0508,,20152016,8476525,Colin Miller
80,14,48,62,0.081395,5.73,20242025,8477504,Josh Morrissey
81,10,59,69,0.05102,5.79,20232024,8477504,Josh Morrissey
78,16,60,76,0.093023,7.4,20222023,8477504,Josh Morrissey
79,12,25,37,0.069,0.2,20212022,8477504,Josh Morrissey
56,4,17,21,0.034,0.41,20202021,8477504,Josh Morrissey
65,5,26,31,0.042,,20192020,8477504,Josh Morrissey
59,6,25,31,0.0632,,20182019,8477504,Josh Morrissey
81,7,19,26,0.0686,,20172018,8477504,Josh Morrissey
82,6,14,20,0.0606,,20162017,8477504,Josh Morrissey
1,0,0,0,0.0,,20152016,8477504,Josh Morrissey
69,10,29,39,0.081301,5.73,20242025,8480145,Neal Pionk
82,5,28,33,0.034247,5.79,20232024,8480145,Neal Pionk
82,10,23,33,0.070423,7.4,20222023,8480145,Neal Pionk
77,3,31,34,0.021,0.2,20212022,8480145,Neal Pionk
54,3,29,32,0.03,0.41,20202021,8480145,Neal Pionk
71,6,39,45,0.034,,20192020,8480145,Neal Pionk
73,6,20,26,0.0455,,20182019,8480145,Neal Pionk
28,1,13,14,0.0185,,20172018,8480145,Neal Pionk
15,0,2,2,0.0,5.73,20242025,8474568,Luke Schenn
63,1,6,7,0.012346,5.79,20232024,8474568,Luke Schenn
15,1,0,1,0.076923,7.4,20222023,8474568,Luke Schenn
66,5,12,17,0.064,0.2,20212022,8474568,Luke Schenn
38,2,2,4,0.047,0.41,20202021,8474568,Luke Schenn
25,1,2,3,0.032,,20192020,8474568,Luke Schenn
18,0,2,2,0.0,,20182019,8474568,Luke Schenn
64,1,6,7,0.0169,,20172018,8474568,Luke Schenn
78,1,7,8,0.0106,,20162017,8474568,Luke Schenn
43,2,9,11,0.0351,,20152016,8474568,Luke Schenn
58,3,11,14,0.0448,,20142015,8474568,Luke Schenn
79,4,8,12,0.0513,,20132014,8474568,Luke Schenn
47,3,8,11,0.037,,20122013,8474568,Luke Schenn
79,2,20,22,0.0247,,20112012,8474568,Luke Schenn
82,5,17,22,0.0391,,20102011,8474568,Luke Schenn
79,5,12,17,0.0495,,20092010,8474568,Luke Schenn
70,2,12,14,0.0196,,20082009,8474568,Luke Schenn
63,1,13,14,0.020408,5.73,20242025,8479378,Logan Stanley
25,1,1,2,0.034483,5.79,20232024,8479378,Logan Stanley
19,1,2,3,0.090909,7.4,20222023,8479378,Logan Stanley
58,1,12,13,0.013,0.2,20212022,8479378,Logan Stanley
37,1,3,4,0.016,0.41,20202021,8479378,Logan Stanley
18,2,3,5,0.068966,5.73,20242025,8478463,Anthony Beauvillier
15,1,2,3,0.03125,5.79,20232024,8478463,Anthony Beauvillier
33,9,11,20,0.142857,7.4,20222023,8478463,Anthony Beauvillier
75,12,22,34,0.078,0.2,20212022,8478463,Anthony Beauvillier
47,15,13,28,0.138,0.41,20202021,8478463,Anthony Beauvillier
68,18,21,39,0.136,,20192020,8478463,Anthony Beauvillier
81,18,10,28,0.1154,,20182019,8478463,Anthony Beauvillier
71,21,15,36,0.1591,,20172018,8478463,Anthony Beauvillier
66,9,15,24,0.0891,,20162017,8478463,Anthony Beauvillier
82,14,13,27,0.162791,5.73,20242025,8475343,Nic Dowd
64,12,10,22,0.196721,5.79,20232024,8475343,Nic Dowd
65,13,12,25,0.209677,7.4,20222023,8475343,Nic Dowd
64,10,14,24,0.111,0.2,20212022,8475343,Nic Dowd
56,11,4,15,0.162,0.41,20202021,8475343,Nic Dowd
56,7,8,15,0.135,,20192020,8475343,Nic Dowd
64,8,14,22,0.1702,,20182019,8475343,Nic Dowd
40,3,0,3,0.075,,20172018,8475343,Nic Dowd
70,6,16,22,0.0769,,20162017,8475343,Nic Dowd
5,0,0,0,0.0,,20152016,8475343,Nic Dowd
82,20,46,66,0.140845,5.73,20242025,8479400,Pierre-Luc Dubois
82,16,24,40,0.109589,5.79,20232024,8479400,Pierre-Luc Dubois
73,27,36,63,0.131707,7.4,20222023,8479400,Pierre-Luc Dubois
81,28,32,60,0.12,0.2,20212022,8479400,Pierre-Luc Dubois
41,8,12,20,0.116,0.41,20202021,8479400,Pierre-Luc Dubois
70,18,31,49,0.114,,20192020,8479400,Pierre-Luc Dubois
82,27,34,61,0.1552,,20182019,8479400,Pierre-Luc Dubois
82,20,28,48,0.1212,,20172018,8479400,Pierre-Luc Dubois
82,26,31,57,0.146893,5.73,20242025,8481580,Connor McMichael
80,18,15,33,0.133333,5.79,20232024,8481580,Connor McMichael
6,0,0,0,0.0,7.4,20222023,8481580,Connor McMichael
68,9,9,18,0.086,0.2,20212022,8481580,Connor McMichael
1,0,0,0,0.0,0.41,20202021,8481580,Connor McMichael
3,0,0,0,0.0,5.73,20242025,8477947,Sonny Milano
49,15,8,23,0.3,5.79,20232024,8477947,Sonny Milano
64,11,22,33,0.1375,7.4,20222023,8477947,Sonny Milano
66,14,20,34,0.149,0.2,20212022,8477947,Sonny Milano
6,0,0,0,0.0,0.41,20202021,8477947,Sonny Milano
9,2,3,5,0.182,,20192020,8477947,Sonny Milano
8,1,0,1,0.2,,20182019,8477947,Sonny Milano
55,14,8,22,0.2029,,20172018,8477947,Sonny Milano
4,0,0,0,0.0,,20162017,8477947,Sonny Milano
3,0,1,1,0.0,,20152016,8477947,Sonny Milano
65,44,29,73,0.185654,5.73,20242025,8471214,Alex Ovechkin
79,31,34,65,0.113971,5.79,20232024,8471214,Alex Ovechkin
73,42,33,75,0.142857,7.4,20222023,8471214,Alex Ovechkin
77,50,40,90,0.15,0.2,20212022,8471214,Alex Ovechkin
45,24,18,42,0.132,0.41,20202021,8471214,Alex Ovechkin
68,48,19,67,0.154,,20192020,8471214,Alex Ovechkin
81,51,38,89,0.1509,,20182019,8471214,Alex Ovechkin
82,49,38,87,0.138,,20172018,8471214,Alex Ovechkin
82,33,36,69,0.1054,,20162017,8471214,Alex Ovechkin
79,50,21,71,0.1256,,20152016,8471214,Alex Ovechkin
81,53,28,81,0.1342,,20142015,8471214,Alex Ovechkin
78,51,28,79,0.1321,,20132014,8471214,Alex Ovechkin
48,32,24,56,0.1455,,20122013,8471214,Alex Ovechkin
78,38,27,65,0.1254,,20112012,8471214,Alex Ovechkin
79,32,53,85,0.0872,,20102011,8471214,Alex Ovechkin
72,50,59,109,0.1359,,20092010,8471214,Alex Ovechkin
79,56,54,110,0.1061,,20082009,8471214,Alex Ovechkin
82,65,47,112,0.1457,,20072008,8471214,Alex Ovechkin
82,46,46,92,0.1173,,20062007,8471214,Alex Ovechkin
81,52,54,106,0.1224,,20052006,8471214,Alex Ovechkin
82,29,53,82,0.194631,5.73,20242025,8478440,Dylan Strome
82,27,40,67,0.159763,5.79,20232024,8478440,Dylan Strome
81,23,42,65,0.149351,7.4,20222023,8478440,Dylan Strome
69,22,26,48,0.175,0.2,20212022,8478440,Dylan Strome
40,9,8,17,0.127,0.41,20202021,8478440,Dylan Strome
58,12,26,38,0.124,,20192020,8478440,Dylan Strome
58,17,34,51,0.1619,,20182019,8478440,Dylan Strome
21,4,5,9,0.1333,,20172018,8478440,Dylan Strome
7,0,1,1,0.0,,20162017,8478440,Dylan Strome
81,33,32,65,0.195266,5.73,20242025,8476880,Tom Wilson
74,18,17,35,0.106509,5.79,20232024,8476880,Tom Wilson
33,13,9,22,0.158537,7.4,20222023,8476880,Tom Wilson
78,24,28,52,0.159,0.2,20212022,8476880,Tom Wilson
47,13,20,33,0.157,0.41,20202021,8476880,Tom Wilson
68,21,23,44,0.136,,20192020,8476880,Tom Wilson
63,22,18,40,0.1692,,20182019,8476880,Tom Wilson
78,14,21,35,0.1138,,20172018,8476880,Tom Wilson
82,7,12,19,0.0737,,20162017,8476880,Tom Wilson
82,7,16,23,0.0707,,20152016,8476880,Tom Wilson
67,4,13,17,0.0506,,20142015,8476880,Tom Wilson
82,3,7,10,0.0476,,20132014,8476880,Tom Wilson
79,5,46,51,0.02994,5.73,20242025,8474590,John Carlson
82,10,42,52,0.056818,5.79,20232024,8474590,John Carlson
40,9,20,29,0.072581,7.4,20222023,8474590,John Carlson
78,17,54,71,0.087,0.2,20212022,8474590,John Carlson
52,10,34,44,0.078,0.41,20202021,8474590,John Carlson
69,15,60,75,0.079,,20192020,8474590,John Carlson
80,13,57,70,0.0703,,20182019,8474590,John Carlson
82,15,53,68,0.0633,,20172018,8474590,John Carlson
72,9,28,37,0.05,,20162017,8474590,John Carlson
56,8,31,39,0.0645,,20152016,8474590,John Carlson
82,12,43,55,0.0622,,20142015,8474590,John Carlson
82,10,27,37,0.0481,,20132014,8474590,John Carlson
48,6,16,22,0.0619,,20122013,8474590,John Carlson
82,9,23,32,0.0592,,20112012,8474590,John Carlson
82,7,30,37,0.0486,,20102011,8474590,John Carlson
22,1,5,6,0.0476,,20092010,8474590,John Carlson
74,20,27,47,0.111732,5.73,20242025,8479345,Jakob Chychrun
82,14,27,41,0.068627,5.79,20232024,8479345,Jakob Chychrun
12,2,3,5,0.066667,7.4,20222023,8479345,Jakob Chychrun
47,7,14,21,0.05,0.2,20212022,8479345,Jakob Chychrun
56,18,23,41,0.102,0.41,20202021,8479345,Jakob Chychrun
63,12,14,26,0.081,,20192020,8479345,Jakob Chychrun
53,5,15,20,0.0427,,20182019,8479345,Jakob Chychrun
50,4,10,14,0.0392,,20172018,8479345,Jakob Chychrun
68,7,13,20,0.0814,,20162017,8479345,Jakob Chychrun
81,5,20,25,0.065789,5.73,20242025,8480796,Martin Fehérváry
66,3,13,16,0.04918,5.79,20232024,8480796,Martin Fehérváry
67,6,10,16,0.065934,7.4,20222023,8480796,Martin Fehérváry
79,8,9,17,0.083,0.2,20212022,8480796,Martin Fehérváry
17,0,2,2,0.0,5.73,20242025,8475795,Dylan McIlrath
3,0,1,1,0.0,5.79,20232024,8475795,Dylan McIlrath
6,0,1,1,0.0,7.4,20222023,8475795,Dylan McIlrath
69,3,21,24,0.035714,5.73,20242025,8478911,Matt Roy
81,5,20,25,0.037037,5.79,20232024,8478911,Matt Roy
82,9,17,26,0.066667,7.4,20222023,8478911,Matt Roy
67,2,19,21,0.013,0.2,20212022,8478911,Matt Roy
44,2,8,10,0.035,0.41,20202021,8478911,Matt Roy
70,4,14,18,0.036,,20192020,8478911,Matt Roy
25,2,4,6,0.0588,,20182019,8478911,Matt Roy
82,4,26,30,0.051282,5.73,20242025,8480873,Rasmus Sandin
68,3,20,23,0.037975,5.79,20232024,8480873,Rasmus Sandin
19,3,12,15,0.130435,7.4,20222023,8480873,Rasmus Sandin
51,5,11,16,0.109,0.2,20212022,8480873,Rasmus Sandin
9,0,4,4,0.0,0.41,20202021,8480873,Rasmus Sandin
28,1,7,8,0.045,,20192020,8480873,Rasmus Sandin
82,1,20,21,0.0125,5.73,20242025,8477845,Trevor van Riemsdyk
70,0,14,14,0.0,5.79,20232024,8477845,Trevor van Riemsdyk
75,7,16,23,0.072165,7.4,20222023,8477845,Trevor van Riemsdyk
72,1,16,17,0.013,0.2,20212022,8477845,Trevor van Riemsdyk
20,1,2,3,0.043,0.41,20202021,8477845,Trevor van Riemsdyk
49,1,7,8,0.017,,20192020,8477845,Trevor van Riemsdyk
78,3,11,14,0.0294,,20182019,8477845,Trevor van Riemsdyk
79,3,13,16,0.027,,20172018,8477845,Trevor van Riemsdyk
58,5,11,16,0.0685,,20162017,8477845,Trevor van Riemsdyk
82,3,11,14,0.0353,,20152016,8477845,Trevor van Riemsdyk
18,0,1,1,0.0,,20142015,8477845,Trevor van Riemsdyk
